county,state_name,base_2020,estimate_2022,pop_diff,pct_change_2020_2022
Maricopa County,Arizona,4420574,4551524,130950,2.962
Collin County,Texas,1066465,1158696,92231,8.648
Denton County,Texas,906405,977281,70876,7.819
Fort Bend County,Texas,822779,889146,66367,8.066
Williamson County,Texas,609010,671418,62408,10.247
Polk County,Florida,725041,787404,62363,8.601
Lee County,Florida,760820,822453,61633,8.101
Montgomery County,Texas,620451,678490,58039,9.354
Clark County,Nevada,2265469,2322985,57516,2.539
Riverside County,California,2418177,2473902,55725,2.304
Hillsborough County,Florida,1459773,1513301,53528,3.667
Bexar County,Texas,2009322,2059530,50208,2.499
Harris County,Texas,4731129,4780913,49784,1.052
Pasco County,Florida,561897,608794,46897,8.346
Wake County,North Carolina,1129393,1175021,45628,4.04
Tarrant County,Texas,2110608,2154595,43987,2.084
Utah County,Utah,659392,702434,43042,6.528
Pinal County,Arizona,425257,464154,38897,9.147
Travis County,Texas,1290209,1326436,36227,2.808
Osceola County,Florida,388664,422545,33881,8.717
St. Johns County,Florida,273427,306841,33414,12.22
Horry County,South Carolina,351028,383101,32073,9.137
Mecklenburg County,North Carolina,1115526,1145392,29866,2.677
St. Lucie County,Florida,329227,358704,29477,8.953
Manatee County,Florida,399705,429125,29420,7.36
Sarasota County,Florida,434005,462286,28281,6.516
Hays County,Texas,241066,269225,28159,11.681
Kaufman County,Texas,145303,172366,27063,18.625
Palm Beach County,Florida,1492198,1518477,26279,1.761
Lake County,Florida,383959,410139,26180,6.818
Volusia County,Florida,553561,579192,25631,4.63
Brevard County,Florida,606603,630693,24090,3.971
Ada County,Idaho,494964,518907,23943,4.837
Comal County,Texas,161482,184642,23160,14.342
Orange County,Florida,1429901,1452726,22825,1.596
Greenville County,South Carolina,525539,547950,22411,4.264
Collier County,Florida,375760,397994,22234,5.917
Weld County,Colorado,328976,350176,21200,6.444
Duval County,Florida,995560,1016536,20976,2.107
Marion County,Florida,375906,396415,20509,5.456
Canyon County,Idaho,231106,251065,19959,8.636
Ellis County,Texas,192441,212182,19741,10.258
Rutherford County,Tennessee,341481,360619,19138,5.604
Johnston County,North Carolina,215991,234778,18787,8.698
Sussex County,Delaware,237380,255956,18576,7.825
Benton County,Arkansas,284329,302863,18534,6.519
Ocean County,New Jersey,637229,655735,18506,2.904
Gwinnett County,Georgia,957027,975353,18326,1.915
Douglas County,Colorado,357998,375988,17990,5.025
Spartanburg County,South Carolina,328002,345831,17829,5.436
Bell County,Texas,370644,388386,17742,4.787
Parker County,Texas,148228,165834,17606,11.878
Hidalgo County,Texas,870796,888367,17571,2.018
Hamilton County,Indiana,347465,364921,17456,5.024
Washington County,Utah,180281,197680,17399,9.651
Brunswick County,North Carolina,136694,153064,16370,11.976
Brazoria County,Texas,372040,388181,16141,4.339
Forsyth County,Georgia,251283,267237,15954,6.349
Charlotte County,Florida,186850,202661,15811,8.462
Knox County,Tennessee,478981,494574,15593,3.255
Johnson County,Texas,179999,195506,15507,8.615
Madison County,Alabama,388160,403565,15405,3.969
Rockwall County,Texas,107832,123208,15376,14.259
Frederick County,Maryland,271709,287079,15370,5.657
Berkeley County,South Carolina,229854,245117,15263,6.64
Sumter County,Florida,129751,144970,15219,11.729
Montgomery County,Tennessee,219994,235201,15207,6.912
Canadian County,Oklahoma,154154,169149,14995,9.727
Baldwin County,Alabama,231761,246435,14674,6.332
Cherokee County,Georgia,266625,281278,14653,5.496
Pima County,Arizona,1043434,1057597,14163,1.357
San Joaquin County,California,779227,793229,14002,1.797
Chesterfield County,Virginia,364546,378408,13862,3.803
Clark County,Washington,503309,516779,13470,2.676
Williamson County,Tennessee,247733,260815,13082,5.281
Placer County,California,404740,417772,13032,3.22
Hernando County,Florida,194515,206896,12381,6.365
Kootenai County,Idaho,171374,183578,12204,7.121
Delaware County,Ohio,214120,226296,12176,5.687
York County,South Carolina,282108,294248,12140,4.303
Snohomish County,Washington,827947,840079,12132,1.465
San Bernardino County,California,2181662,2193656,11994,0.55
Chester County,Pennsylvania,534408,545823,11415,2.136
Flagler County,Florida,115383,126705,11322,9.813
Loudoun County,Virginia,420955,432085,11130,2.644
Charleston County,South Carolina,408317,419279,10962,2.685
Union County,North Carolina,238233,249070,10837,4.549
Lexington County,South Carolina,293985,304797,10812,3.678
Wilson County,Tennessee,147747,158555,10808,7.315
Liberty County,Texas,91632,101992,10360,11.306
Spokane County,Washington,539332,549690,10358,1.921
Santa Rosa County,Florida,187991,198268,10277,5.467
Washoe County,Nevada,486489,496745,10256,2.108
Washington County,Arkansas,245866,256054,10188,4.144
El Paso County,Colorado,730402,740567,10165,1.392
Guadalupe County,Texas,172709,182760,10051,5.82
Cabarrus County,North Carolina,225807,235797,9990,4.424
Yavapai County,Arizona,236218,246191,9973,4.222
Bay County,Florida,175204,185134,9930,5.668
Paulding County,Georgia,168660,178421,9761,5.787
Tuscaloosa County,Alabama,227041,236780,9739,4.29
Hall County,Georgia,203166,212692,9526,4.689
Johnson County,Kansas,609864,619195,9331,1.53
Beaufort County,South Carolina,187108,196371,9263,4.951
New Hanover County,North Carolina,225705,234921,9216,4.083
Iredell County,North Carolina,186699,195897,9198,4.927
Cumberland County,Pennsylvania,259464,268579,9115,3.513
Bastrop County,Texas,97218,106188,8970,9.227
Merced County,California,281202,290014,8812,3.134
St. Tammany Parish,Louisiana,264575,273263,8688,3.284
Polk County,Iowa,492411,501089,8678,1.762
Citrus County,Florida,153855,162529,8674,5.638
Lancaster County,South Carolina,96010,104577,8567,8.923
St. Charles County,Missouri,405262,413803,8541,2.108
Hamilton County,Tennessee,366215,374682,8467,2.312
Smith County,Texas,233484,241922,8438,3.614
Washington County,Minnesota,267563,275912,8349,3.12
Dallas County,Iowa,99677,108016,8339,8.366
Clay County,Florida,218250,226589,8339,3.821
Hunt County,Texas,99957,108282,8325,8.329
Deschutes County,Oregon,198256,206549,8293,4.183
Cass County,North Dakota,184528,192734,8206,4.447
Brazos County,Texas,233848,242014,8166,3.492
Montgomery County,Pennsylvania,856559,864683,8124,0.948
Tulsa County,Oklahoma,669272,677358,8086,1.208
Jackson County,Georgia,75904,83936,8032,10.582
Walton County,Florida,75306,83304,7998,10.621
Adams County,Colorado,519582,527575,7993,1.538
Fulton County,Georgia,1066702,1074634,7932,0.744
Seminole County,Florida,470855,478772,7917,1.681
Durham County,North Carolina,324849,332680,7831,2.411
Hendricks County,Indiana,174792,182534,7742,4.429
Larimer County,Colorado,359066,366778,7712,2.148
Henry County,Georgia,240719,248364,7645,3.176
Grayson County,Texas,135552,143131,7579,5.591
Sumner County,Tennessee,196281,203858,7577,3.86
Indian River County,Florida,159789,167352,7563,4.733
Mohave County,Arizona,213269,220816,7547,3.539
Nassau County,Florida,90355,97899,7544,8.349
Flathead County,Montana,104349,111814,7465,7.154
Warren County,Ohio,242338,249778,7440,3.07
Berkeley County,West Virginia,122078,129490,7412,6.072
Weber County,Utah,262213,269561,7348,2.802
Limestone County,Alabama,103563,110900,7337,7.085
Davis County,Utah,362689,369948,7259,2.001
Tooele County,Utah,72697,79934,7237,9.955
Maury County,Tennessee,100975,108159,7184,7.115
Shelby County,Alabama,223034,230115,7081,3.175
Cache County,Utah,133159,140173,7014,5.267
Lubbock County,Texas,310642,317561,6919,2.227
Kern County,California,909244,916108,6864,0.755
Minnehaha County,South Dakota,197209,203971,6762,3.429
Coweta County,Georgia,146154,152882,6728,4.603
Dane County,Wisconsin,561507,568203,6696,1.193
Wright County,Minnesota,141336,148003,6667,4.717
Spotsylvania County,Virginia,140094,146688,6594,4.707
Forsyth County,North Carolina,382584,389157,6573,1.718
Fresno County,California,1008650,1015190,6540,0.648
Lee County,Alabama,174244,180773,6529,3.747
Galveston County,Texas,350673,357117,6444,1.838
Stafford County,Virginia,156937,163380,6443,4.105
Columbia County,Georgia,156010,162419,6409,4.108
DeSoto County,Mississippi,185317,191723,6406,3.457
Walton County,Georgia,96669,103065,6396,6.616
Lincoln County,North Carolina,86816,93095,6279,7.233
Gaston County,North Carolina,227942,234215,6273,2.752
Wise County,Texas,68632,74895,6263,9.125
McLennan County,Texas,260582,266836,6254,2.4
Matanuska-Susitna Borough,Alaska,107082,113325,6243,5.83
Pierce County,Washington,921137,927380,6243,0.678
Livingston Parish,Louisiana,142284,148425,6141,4.316
Lafayette Parish,Louisiana,241756,247866,6110,2.527
Allen County,Indiana,385411,391449,6038,1.567
Oklahoma County,Oklahoma,796567,802559,5992,0.752
Houston County,Georgia,163641,169631,5990,3.66
Franklin County,North Carolina,68578,74539,5961,8.692
Sarpy County,Nebraska,190597,196553,5956,3.125
Benton County,Washington,206875,212791,5916,2.86
Gallatin County,Montana,118957,124857,5900,4.96
Anderson County,South Carolina,203723,209581,5858,2.875
Chatham County,Georgia,295280,301107,5827,1.973
Lincoln County,South Dakota,65165,70987,5822,8.934
Moore County,North Carolina,99725,105531,5806,5.822
Cobb County,Georgia,766160,771952,5792,0.756
Barrow County,Georgia,83507,89299,5792,6.936
Yolo County,California,216405,222115,5710,2.639
Hawaii County,Hawaii,200631,206315,5684,2.833
Wagoner County,Oklahoma,80986,86644,5658,6.986
Northampton County,Pennsylvania,312955,318526,5571,1.78
Alachua County,Florida,278475,284030,5555,1.995
Bonneville County,Idaho,123955,129496,5541,4.47
Pender County,North Carolina,60208,65737,5529,9.183
Carroll County,Georgia,119141,124592,5451,4.575
Richland County,South Carolina,416145,421566,5421,1.303
Kendall County,Illinois,131868,137254,5386,4.084
Randall County,Texas,140761,146140,5379,3.821
Aiken County,South Carolina,168811,174150,5339,3.163
Warren County,Kentucky,134551,139843,5292,3.933
Harnett County,North Carolina,133554,138832,5278,3.952
Rockingham County,New Hampshire,314182,319424,5242,1.668
Pennington County,South Dakota,109231,114461,5230,4.788
Capitol Planning Region,Connecticut,976269,981447,5178,0.53
Leon County,Florida,292203,297369,5166,1.768
Iron County,Utah,57285,62429,5144,8.98
Waller County,Texas,56763,61894,5131,9.039
Yellowstone County,Montana,164722,169852,5130,3.114
Newton County,Georgia,112491,117621,5130,4.56
Kent County,Delaware,181856,186946,5090,2.799
Anne Arundel County,Maryland,588265,593286,5021,0.854
Anoka County,Minnesota,363892,368864,4972,1.366
Alamance County,North Carolina,171429,176353,4924,2.872
Okaloosa County,Florida,211664,216482,4818,2.276
Guilford County,North Carolina,541309,546101,4792,0.885
Hood County,Texas,61597,66373,4776,7.754
New Castle County,Delaware,570721,575494,4773,0.836
York County,Maine,211981,216732,4751,2.241
Prince William County,Virginia,482198,486943,4745,0.984
Chambers County,Texas,46571,51288,4717,10.129
Kendall County,Texas,44281,48973,4692,10.596
Blount County,Tennessee,135283,139958,4675,3.456
Sandoval County,New Mexico,148829,153501,4672,3.139
Ottawa County,Michigan,296207,300873,4666,1.575
Dorchester County,South Carolina,161469,166133,4664,2.888
Orange County,New York,401324,405941,4617,1.15
York County,Pennsylvania,456442,461058,4616,1.011
Tulare County,California,473117,477544,4427,0.936
Highlands County,Florida,101238,105618,4380,4.326
Greene County,Missouri,298915,303293,4378,1.465
Cumberland County,Maine,303076,307451,4375,1.444
Gloucester County,New Jersey,302285,306601,4316,1.428
Bonner County,Idaho,47105,51414,4309,9.148
Effingham County,Georgia,64768,69041,4273,6.597
Christian County,Missouri,88846,93114,4268,4.804
Burlington County,New Jersey,461863,466103,4240,0.918
Suffolk city,Virginia,94326,98537,4211,4.464
Cameron County,Texas,421012,425208,4196,0.997
Faulkner County,Arkansas,123498,127665,4167,3.374
Buncombe County,North Carolina,269446,273589,4143,1.538
Union County,Ohio,62790,66898,4108,6.542
Boone County,Missouri,183607,187690,4083,2.224
Cleveland County,Oklahoma,295514,299587,4073,1.378
Johnson County,Indiana,161768,165782,4014,2.481
Madera County,California,156259,160256,3997,2.558
Fairfield County,Ohio,158918,162898,3980,2.504
Yuma County,Arizona,203880,207842,3962,1.943
Thurston County,Washington,294797,298758,3961,1.344
Ascension Parish,Louisiana,126498,130458,3960,3.13
Saline County,Arkansas,123424,127357,3933,3.187
Bartow County,Georgia,108888,112816,3928,3.607
Tangipahoa Parish,Louisiana,133149,137048,3899,2.928
Whatcom County,Washington,226843,230677,3834,1.69
Box Elder County,Utah,57669,61498,3829,6.64
Platte County,Missouri,106718,110534,3816,3.576
Doña Ana County,New Mexico,219567,223337,3770,1.717
Clay County,Missouri,253322,257033,3711,1.465
Lancaster County,Pennsylvania,552969,556629,3660,0.662
Davidson County,North Carolina,168933,172586,3653,2.162
Hillsborough County,New Hampshire,422941,426594,3653,0.864
Twin Falls County,Idaho,90045,93696,3651,4.055
McClain County,Oklahoma,41667,45306,3639,8.734
Sherburne County,Minnesota,97186,100824,3638,3.743
Naugatuck Valley Planning Region,Connecticut,450447,454083,3636,0.807
Frederick County,Virginia,91421,95051,3630,3.971
Chatham County,North Carolina,76270,79864,3594,4.712
Rogers County,Oklahoma,95245,98836,3591,3.77
Scott County,Minnesota,150930,154520,3590,2.379
Lincoln County,Missouri,59577,63155,3578,6.006
Martin County,Florida,158435,162006,3571,2.254
Johnson County,Iowa,152861,156420,3559,2.328
Butler County,Pennsylvania,193767,197300,3533,1.823
Bryan County,Georgia,44739,48225,3486,7.792
Charles County,Maryland,166621,170102,3481,2.089
Waukesha County,Wisconsin,406971,410434,3463,0.851
Dakota County,Minnesota,439884,443341,3457,0.786
Barnstable County,Massachusetts,229004,232457,3453,1.508
Bulloch County,Georgia,79647,83059,3412,4.284
Burnet County,Texas,49123,52502,3379,6.879
San Benito County,California,64207,67579,3372,5.252
Boone County,Indiana,70814,74164,3350,4.731
Dawson County,Georgia,26796,30138,3342,12.472
Van Zandt County,Texas,59540,62859,3319,5.574
Pitt County,North Carolina,170241,173542,3301,1.939
Saratoga County,New York,235499,238797,3298,1.4
Lorain County,Ohio,312974,316268,3294,1.052
Loudon County,Tennessee,54887,58181,3294,6.001
Jasper County,South Carolina,28806,32039,3233,11.223
Hancock County,Indiana,79851,83070,3219,4.031
Lewis County,Washington,82152,85370,3218,3.917
Washington County,Tennessee,133005,136172,3167,2.381
Western Connecticut Planning Region,Connecticut,620531,623690,3159,0.509
Nye County,Nevada,51590,54738,3148,6.102
Clark County,Indiana,121091,124237,3146,2.598
Polk County,Texas,50119,53255,3136,6.257
Ravalli County,Montana,44172,47298,3126,7.077
Carver County,Minnesota,106914,110034,3120,2.918
Missoula County,Montana,117924,121041,3117,2.643
El Paso County,Texas,865655,868763,3108,0.359
Boone County,Kentucky,135995,139093,3098,2.278
Howard County,Maryland,332316,335411,3095,0.931
Douglas County,Georgia,144227,147316,3089,2.142
Chesapeake city,Virginia,249415,252488,3073,1.232
Medina County,Texas,50739,53723,2984,5.881
Escambia County,Florida,321897,324878,2981,0.926
Wilson County,Texas,49757,52735,2978,5.985
Hanover County,Virginia,109980,112938,2958,2.69
James City County,Virginia,78255,81199,2944,3.762
Harford County,Maryland,260924,263867,2943,1.128
Mesa County,Colorado,155710,158636,2926,1.879
Currituck County,North Carolina,28103,31015,2912,10.362
Lewis and Clark County,Montana,70967,73832,2865,4.037
Catawba County,North Carolina,160609,163462,2853,1.776
Licking County,Ohio,178509,181359,2850,1.597
Fayette County,Georgia,119186,122030,2844,2.386
Cullman County,Alabama,87857,90665,2808,3.196
South Central Connecticut Planning Region,Connecticut,570453,573244,2791,0.489
Richmond city,Virginia,226618,229395,2777,1.225
Rowan County,North Carolina,146878,149645,2767,1.884
Jefferson County,Missouri,226572,229336,2764,1.22
Liberty County,Georgia,65274,68030,2756,4.222
Yuba County,California,81578,84310,2732,3.349
Onslow County,North Carolina,204585,207298,2713,1.326
Robertson County,Tennessee,72803,75470,2667,3.663
Sullivan County,Tennessee,158161,160820,2659,1.681
Broward County,Florida,1944376,1947026,2650,0.136
Pinellas County,Florida,959103,961739,2636,0.275
Cass County,Missouri,107816,110394,2578,2.391
Jefferson County,Idaho,30889,33428,2539,8.22
Putnam County,Tennessee,79844,82382,2538,3.179
Louisa County,Virginia,37603,40116,2513,6.683
Bannock County,Idaho,87017,89517,2500,2.873
Madison County,Kentucky,92707,95187,2480,2.675
St. Croix County,Wisconsin,93539,96017,2478,2.649
Tippecanoe County,Indiana,186249,188717,2468,1.325
Walker County,Texas,76402,78870,2468,3.23
St. Clair County,Alabama,91471,93932,2461,2.69
Benton County,Oregon,95183,97630,2447,2.571
Mason County,Washington,65722,68166,2444,3.719
Harrison County,Mississippi,208621,211044,2423,1.161
Carroll County,Maryland,172890,175305,2415,1.397
Dauphin County,Pennsylvania,286399,288800,2401,0.838
Lower Connecticut River Valley Planning Region,Connecticut,174221,176622,2401,1.378
Logan County,Oklahoma,49552,51933,2381,4.805
Cumberland County,Tennessee,61152,63522,2370,3.876
Henderson County,Texas,82145,84511,2366,2.88
Levy County,Florida,42912,45260,2348,5.472
Lyon County,Nevada,59240,61585,2345,3.958
Kershaw County,South Carolina,65407,67751,2344,3.584
Lauderdale County,Alabama,93565,95878,2313,2.472
Livingston County,Michigan,193869,196161,2292,1.182
Plymouth County,Massachusetts,530820,533069,2249,0.424
Camden County,Georgia,54769,57013,2244,4.097
Merrimack County,New Hampshire,153800,156020,2220,1.443
Clermont County,Ohio,208592,210805,2213,1.061
Columbia County,Florida,69701,71908,2207,3.166
Adams County,Pennsylvania,103829,106027,2198,2.117
Lee County,North Carolina,63281,65476,2195,3.469
Grant County,Washington,99120,101311,2191,2.21
Long County,Georgia,16158,18348,2190,13.554
Polk County,Oregon,87432,89614,2182,2.496
Lancaster County,Nebraska,322615,324756,2141,0.664
Albemarle County,Virginia,112396,114534,2138,1.902
Bryan County,Oklahoma,46072,48182,2110,4.58
Stearns County,Minnesota,158297,160405,2108,1.332
Otsego County,New York,58529,60636,2107,3.6
Carroll County,New Hampshire,50098,52199,2101,4.194
Kitsap County,Washington,275605,277673,2068,0.75
Madison County,Idaho,52908,54976,2068,3.909
Pickens County,South Carolina,131401,133462,2061,1.568
Jefferson County,Tennessee,54679,56727,2048,3.745
New Kent County,Virginia,22942,24986,2044,8.909
Schenectady County,New York,158058,160093,2035,1.288
Pike County,Pennsylvania,58537,60558,2021,3.453
Broomfield County,Colorado,74105,76121,2016,2.72
Midland County,Texas,169984,171999,2015,1.185
Navarro County,Texas,52623,54636,2013,3.825
Wood County,Texas,44855,46857,2002,4.463
Bradley County,Tennessee,108620,110616,1996,1.838
Cumberland County,North Carolina,334728,336699,1971,0.589
Coryell County,Texas,83091,85057,1966,2.366
Madison County,Mississippi,109149,111113,1964,1.799
Caldwell County,Texas,45887,47848,1961,4.274
Taylor County,Texas,143205,145163,1958,1.367
Rankin County,Mississippi,157026,158979,1953,1.244
Scott County,Kentucky,57153,59099,1946,3.405
Suwannee County,Florida,43472,45411,1939,4.46
Navajo County,Arizona,106716,108650,1934,1.812
Franklin County,Washington,96746,98678,1932,1.997
Bingham County,Idaho,47995,49923,1928,4.017
Warren County,Iowa,52402,54327,1925,3.674
Comanche County,Oklahoma,121124,123046,1922,1.587
Kennebec County,Maine,123636,125540,1904,1.54
Kenai Peninsula Borough,Alaska,58789,60690,1901,3.234
Randolph County,North Carolina,144151,146043,1892,1.313
Atascosa County,Texas,48985,50864,1879,3.836
Androscoggin County,Maine,111147,113023,1876,1.688
Valencia County,New Mexico,76205,78080,1875,2.46
Morris County,New Jersey,509277,511151,1874,0.368
Grady County,Oklahoma,54800,56658,1858,3.391
Linn County,Oregon,128610,130467,1857,1.444
Sussex County,New Jersey,144231,146084,1853,1.285
Lincoln County,Montana,19678,21525,1847,9.386
Coffee County,Tennessee,57882,59728,1846,3.189
Queen Anne's County,Maryland,49871,51711,1840,3.69
Wasatch County,Utah,34791,36619,1828,5.254
Culpeper County,Virginia,52554,54381,1827,3.476
Henderson County,North Carolina,116279,118106,1827,1.571
Crow Wing County,Minnesota,66122,67948,1826,2.762
Oldham County,Kentucky,67609,69431,1822,2.695
Marshall County,Alabama,97611,99423,1812,1.856
Orange County,Virginia,36184,37991,1807,4.994
Douglas County,Nebraska,584522,586327,1805,0.309
Lafayette County,Mississippi,55812,57615,1803,3.23
Oconee County,Georgia,41799,43588,1789,4.28
Calvert County,Maryland,92785,94573,1788,1.927
Craighead County,Arkansas,111233,113017,1784,1.604
Stevens County,Washington,46450,48229,1779,3.83
Anderson County,Tennessee,77136,78913,1777,2.304
Clackamas County,Oregon,421404,423177,1773,0.421
Orange County,North Carolina,148707,150477,1770,1.19
Union County,Georgia,24626,26388,1762,7.155
Elbert County,Colorado,26049,27799,1750,6.718
Lehigh County,Pennsylvania,374572,376317,1745,0.466
Oxford County,Maine,57766,59495,1729,2.993
Warren County,Missouri,35538,37260,1722,4.846
Lake County,Montana,31132,32853,1721,5.528
Jackson County,Mississippi,143259,144975,1716,1.198
Hendry County,Florida,39626,41339,1713,4.323
Bedford County,Tennessee,50239,51950,1711,3.406
Fauquier County,Virginia,72956,74664,1708,2.341
Hoke County,North Carolina,52081,53787,1706,3.276
Sedgwick County,Kansas,523830,525525,1695,0.324
Carteret County,North Carolina,67686,69380,1694,2.503
Roane County,Tennessee,53393,55082,1689,3.163
Skagit County,Washington,129515,131179,1664,1.285
Dutchess County,New York,295897,297545,1648,0.557
Stanly County,North Carolina,62506,64153,1647,2.635
Crook County,Oregon,24735,26375,1640,6.63
Rockingham County,Virginia,83759,85397,1638,1.956
Fayette County,Tennessee,42002,43630,1628,3.876
Spalding County,Georgia,67301,68919,1618,2.404
Pickens County,Georgia,33215,34826,1611,4.85
Bullitt County,Kentucky,82226,83836,1610,1.958
Berks County,Pennsylvania,428840,430449,1609,0.375
Harris County,Georgia,34669,36276,1607,4.635
Madison County,Indiana,130141,131744,1603,1.232
Upshur County,Texas,40890,42488,1598,3.908
Isanti County,Minnesota,41133,42727,1594,3.875
Elmore County,Alabama,87974,89563,1589,1.806
Porter County,Indiana,173208,174791,1583,0.914
Hardin County,Texas,56234,57811,1577,2.804
Oconee County,South Carolina,78604,80180,1576,2.005
Payette County,Idaho,25385,26956,1571,6.189
Lamar County,Mississippi,64223,65783,1560,2.429
Marshall County,Tennessee,34320,35878,1558,4.54
Isle of Wight County,Virginia,38610,40151,1541,3.991
Uintah County,Utah,35613,37141,1528,4.291
McHenry County,Illinois,310227,311747,1520,0.49
Somerset County,New Jersey,345356,346875,1519,0.44
Ozaukee County,Wisconsin,91499,93009,1510,1.65
Greater Bridgeport Planning Region,Connecticut,325777,327286,1509,0.463
Penobscot County,Maine,152202,153704,1502,0.987
Monroe County,Tennessee,46249,47740,1491,3.224
Lowndes County,Georgia,118249,119739,1490,1.26
Pickaway County,Ohio,58537,60023,1486,2.539
Monroe County,Georgia,27955,29427,1472,5.266
Miami County,Ohio,108777,110247,1470,1.351
Fannin County,Texas,35661,37125,1464,4.105
El Dorado County,California,191184,192646,1462,0.765
Grimes County,Texas,29292,30754,1462,4.991
Hill County,Texas,35869,37329,1460,4.07
Latah County,Idaho,39518,40978,1460,3.695
Lawrence County,South Dakota,25766,27214,1448,5.62
Dickson County,Tennessee,54314,55761,1447,2.664
McMinn County,Tennessee,53275,54719,1444,2.71
Habersham County,Georgia,46033,47475,1442,3.133
Rockdale County,Georgia,93554,94984,1430,1.529
Camden County,New Jersey,523486,524907,1421,0.271
Haralson County,Georgia,29920,31337,1417,4.736
Outagamie County,Wisconsin,190710,192127,1417,0.743
Wakulla County,Florida,33766,35178,1412,4.182
Gordon County,Georgia,57543,58954,1411,2.452
Worcester County,Maryland,52460,53866,1406,2.68
Putnam County,Florida,73327,74731,1404,1.915
Grays Harbor County,Washington,75636,77038,1402,1.854
Bedford County,Virginia,79465,80848,1383,1.74
Goochland County,Virginia,24729,26109,1380,5.58
Strafford County,New Hampshire,130895,132275,1380,1.054
Cooke County,Texas,41671,43050,1379,3.309
Pueblo County,Colorado,168168,169544,1376,0.818
Davie County,North Carolina,42715,44090,1375,3.219
Chisago County,Minnesota,56621,57988,1367,2.414
Newton County,Missouri,58644,60011,1367,2.331
Jasper County,Georgia,14595,15951,1356,9.291
Erath County,Texas,42545,43895,1350,3.173
Madison County,Georgia,30123,31473,1350,4.482
Coffee County,Alabama,53460,54805,1345,2.516
DeSoto County,Florida,33975,35312,1337,3.935
Jasper County,Missouri,122750,124075,1325,1.079
Hawkins County,Tennessee,56718,58043,1325,2.336
Bartholomew County,Indiana,82218,83540,1322,1.608
Georgetown County,South Carolina,63402,64722,1320,2.082
Lumpkin County,Georgia,33487,34796,1309,3.909
Brown County,Wisconsin,268729,270036,1307,0.486
Llano County,Texas,21243,22540,1297,6.106
Gem County,Idaho,19126,20418,1292,6.755
Banks County,Georgia,18037,19328,1291,7.158
Sanpete County,Utah,28435,29724,1289,4.533
Warrick County,Indiana,63896,65185,1289,2.017
Boundary County,Idaho,12057,13345,1288,10.683
Warren County,New Jersey,109638,110926,1288,1.175
York County,Virginia,70055,71341,1286,1.836
Kenton County,Kentucky,169028,170313,1285,0.76
Edgefield County,South Carolina,25648,26932,1284,5.006
Calaveras County,California,45285,46563,1278,2.822
Jefferson County,West Virginia,57707,58979,1272,2.204
Bandera County,Texas,20843,22115,1272,6.103
Jessamine County,Kentucky,52987,54254,1267,2.391
Sebastian County,Arkansas,127800,129059,1259,0.985
Douglas County,Washington,42937,44192,1255,2.923
Walker County,Georgia,67660,68915,1255,1.855
Greene County,Tennessee,70152,71405,1253,1.786
Lawrence County,Tennessee,44163,45415,1252,2.835
Webster County,Missouri,39085,40335,1250,3.198
Cherokee County,Texas,50411,51645,1234,2.448
Greene County,Georgia,18907,20139,1232,6.516
Hancock County,Maine,55477,56701,1224,2.206
Grand Traverse County,Michigan,95246,96464,1218,1.279
Cecil County,Maryland,103726,104942,1216,1.172
Cowlitz County,Washington,110740,111956,1216,1.098
Lonoke County,Arkansas,74010,75225,1215,1.642
Butts County,Georgia,25440,26649,1209,4.752
Cass County,Minnesota,30065,31274,1209,4.021
Gregg County,Texas,124234,125443,1209,0.973
Clarke County,Georgia,128671,129875,1204,0.936
San Patricio County,Texas,68754,69954,1200,1.745
Cape Girardeau County,Missouri,81707,82899,1192,1.459
Franklin County,Missouri,104688,105879,1191,1.138
Douglas County,Kansas,118784,119964,1180,0.993
Franklin County,Tennessee,42769,43942,1173,2.743
Polk County,Missouri,31521,32693,1172,3.718
Sheridan County,Wyoming,30925,32096,1171,3.787
Olmsted County,Minnesota,162849,164020,1171,0.719
Hardin County,Kentucky,110694,111862,1168,1.055
Powhatan County,Virginia,30334,31489,1155,3.808
Lampasas County,Texas,21632,22785,1153,5.33
Cleveland County,North Carolina,99521,100670,1149,1.155
Kerr County,Texas,52594,53741,1147,2.181
Payne County,Oklahoma,81649,82794,1145,1.402
Story County,Iowa,98536,99673,1137,1.154
Eau Claire County,Wisconsin,105702,106837,1135,1.074
King George County,Virginia,26722,27856,1134,4.244
Montrose County,Colorado,42680,43811,1131,2.65
Gilchrist County,Florida,17862,18992,1130,6.326
Barry County,Michigan,62428,63554,1126,1.804
Harrison County,Texas,68834,69955,1121,1.629
Pearl River County,Mississippi,56144,57261,1117,1.99
Gulf County,Florida,14200,15314,1114,7.845
Aransas County,Texas,23831,24944,1113,4.67
Rusk County,Texas,52223,53333,1110,2.126
Pike County,Georgia,18881,19990,1109,5.874
Brookings County,South Dakota,34380,35484,1104,3.211
St. Mary's County,Maryland,113775,114877,1102,0.969
Atlantic County,New Jersey,274536,275638,1102,0.401
Kent County,Michigan,657984,659083,1099,0.167
Montague County,Texas,19965,21063,1098,5.5
Douglas County,Oregon,111202,112297,1095,0.985
Santa Cruz County,Arizona,47665,48759,1094,2.295
Hart County,Georgia,25824,26909,1085,4.202
Pottawatomie County,Oklahoma,72449,73533,1084,1.496
Sequatchie County,Tennessee,15829,16909,1080,6.823
Wicomico County,Maryland,103586,104664,1078,1.041
Lincoln County,Wyoming,19582,20660,1078,5.505
Warren County,Tennessee,40951,42026,1075,2.625
Belknap County,New Hampshire,63709,64781,1072,1.683
Caroline County,Virginia,30886,31957,1071,3.468
Jerome County,Idaho,24241,25311,1070,4.414
Stone County,Missouri,31077,32136,1059,3.408
Washington County,Pennsylvania,209325,210383,1058,0.505
Gilmer County,Georgia,31354,32407,1053,3.358
Idaho County,Idaho,16542,17593,1051,6.354
Macon County,North Carolina,37016,38065,1049,2.834
Monongalia County,West Virginia,105822,106869,1047,0.989
Dare County,North Carolina,36910,37956,1046,2.834
Blanco County,Texas,11376,12418,1042,9.16
Sullivan County,New York,78617,79658,1041,1.324
Sanders County,Montana,12403,13442,1039,8.377
Medina County,Ohio,182475,183512,1037,0.568
Okanogan County,Washington,42098,43127,1029,2.444
Franklin County,Maine,29447,30474,1027,3.488
Cherokee County,Oklahoma,47073,48098,1025,2.177
Camden County,Missouri,42746,43768,1022,2.391
Salt Lake County,Utah,1185236,1186257,1021,0.086
Broadwater County,Montana,6773,7793,1020,15.06
Delaware County,Oklahoma,40393,41413,1020,2.525
Burleson County,Texas,17642,18657,1015,5.753
Macon County,Tennessee,25215,26229,1014,4.021
Hopkins County,Texas,36792,37804,1012,2.751
Watauga County,North Carolina,54077,55089,1012,1.871
Mecosta County,Michigan,39713,40720,1007,2.536
Leavenworth County,Kansas,81897,82892,995,1.215
Franklin County,Idaho,14196,15189,993,6.995
Columbia County,Oregon,52603,53588,985,1.873
Lake County,Indiana,498707,499689,982,0.197
Otero County,New Mexico,67843,68823,980,1.445
Chittenden County,Vermont,168324,169301,977,0.58
Lincoln County,Maine,35240,36215,975,2.767
Albany County,New York,314838,315811,973,0.309
Wright County,Missouri,18187,19156,969,5.328
La Plata County,Colorado,55639,56607,968,1.74
Lamar County,Georgia,18500,19467,967,5.227
Madison County,Arkansas,16521,17486,965,5.841
Cassia County,Idaho,24693,25655,962,3.896
Albany County,Wyoming,37070,38031,961,2.592
Autauga County,Alabama,58802,59759,957,1.627
Catoosa County,Georgia,67873,68826,953,1.404
Franklin County,Pennsylvania,155950,156902,952,0.61
San Jacinto County,Texas,27399,28348,949,3.464
Creek County,Oklahoma,71753,72699,946,1.318
Crawford County,Arkansas,60130,61075,945,1.572
Silver Bow County,Montana,35128,36068,940,2.676
Putnam County,Georgia,22046,22984,938,4.255
Amador County,California,40474,41412,938,2.318
Morgan County,Georgia,20096,21031,935,4.653
White County,Arkansas,76822,77755,933,1.214
Washington County,Wisconsin,136756,137688,932,0.682
Pottawatomie County,Kansas,25344,26273,929,3.666
Austin County,Texas,30168,31097,929,3.079
DeKalb County,Tennessee,20078,21003,925,4.607
Kent County,Rhode Island,170358,171275,917,0.538
Newaygo County,Michigan,49971,50886,915,1.831
Nez Perce County,Idaho,42089,43004,915,2.174
Boone County,Arkansas,37372,38284,912,2.44
Fluvanna County,Virginia,27247,28159,912,3.347
Teton County,Idaho,11633,12544,911,7.831
Granville County,North Carolina,61001,61903,902,1.479
Jackson County,Florida,47309,48211,902,1.907
Cheshire County,New Hampshire,76455,77350,895,1.171
Sullivan County,New Hampshire,43064,43958,894,2.076
Park County,Wyoming,29625,30518,893,3.014
Howell County,Missouri,39748,40631,883,2.221
Washington County,Maryland,154709,155590,881,0.569
Cocke County,Tennessee,35998,36879,881,2.447
Hampton city,Virginia,137158,138037,879,0.641
Milam County,Texas,24750,25628,878,3.547
Chilton County,Alabama,45009,45884,875,1.944
Houston County,Alabama,107204,108079,875,0.816
San Juan County,Washington,17789,18662,873,4.908
Stephens County,Oklahoma,42844,43710,866,2.021
Rhea County,Tennessee,32870,33730,860,2.616
Bristol County,Massachusetts,579210,580068,858,0.148
George County,Mississippi,24348,25206,858,3.524
Floyd County,Georgia,98586,99443,857,0.869
Rockingham County,North Carolina,91100,91957,857,0.941
Butler County,Kansas,67383,68240,857,1.272
Polk County,Georgia,42854,43709,855,1.995
Northeastern Connecticut Planning Region,Connecticut,95344,96196,852,0.894
Shoshone County,Idaho,13164,14012,848,6.442
Chelan County,Washington,79078,79926,848,1.072
Kittitas County,Washington,44342,45189,847,1.91
Meade County,South Dakota,29851,30698,847,2.837
Fentress County,Tennessee,18489,19332,843,4.559
Santa Fe County,New Mexico,154823,155664,841,0.543
Texas County,Missouri,24495,25336,841,3.433
Benewah County,Idaho,9531,10370,839,8.803
Saunders County,Nebraska,22280,23118,838,3.761
West Baton Rouge Parish,Louisiana,27201,28034,833,3.062
Palo Pinto County,Texas,28408,29239,831,2.925
Benton County,Missouri,19395,20224,829,4.274
Worcester County,Massachusetts,862099,862927,828,0.096
Jefferson County,Oregon,24507,25330,823,3.358
Nash County,North Carolina,94967,95789,822,0.866
Antrim County,Michigan,23428,24249,821,3.504
Hunterdon County,New Jersey,128962,129777,815,0.632
Burleigh County,North Dakota,98466,99280,814,0.827
Mille Lacs County,Minnesota,26467,27280,813,3.072
Montcalm County,Michigan,66622,67433,811,1.217
White County,Georgia,28000,28806,806,2.879
Baxter County,Arkansas,41633,42435,802,1.926
Colbert County,Alabama,57232,58033,801,1.4
Monroe County,Michigan,154812,155609,797,0.515
Klamath County,Oregon,69416,70212,796,1.147
Marion County,Oregon,345910,346703,793,0.229
Washington County,Oklahoma,52452,53242,790,1.506
Morgan County,Alabama,123421,124211,790,0.64
Juab County,Utah,11778,12567,789,6.699
Morgan County,Missouri,21000,21785,785,3.738
Shelby County,Kentucky,48101,48886,785,1.632
Franklin County,Vermont,49949,50731,782,1.566
Fredericksburg city,Virginia,27979,28757,778,2.781
Northwest Hills Planning Region,Connecticut,112456,113234,778,0.692
Gloucester County,Virginia,38716,39493,777,2.007
Okeechobee County,Florida,39636,40412,776,1.958
Le Flore County,Oklahoma,48131,48907,776,1.612
Shenandoah County,Virginia,44192,44968,776,1.756
Pend Oreille County,Washington,13404,14179,775,5.782
Spencer County,Kentucky,19433,20204,771,3.967
Cheatham County,Tennessee,41065,41830,765,1.863
Troup County,Georgia,69427,70191,764,1.1
Taney County,Missouri,56058,56821,763,1.361
Pulaski County,Kentucky,65033,65795,762,1.172
Luzerne County,Pennsylvania,325613,326369,756,0.232
Gillespie County,Texas,26722,27477,755,2.825
Oswego County,New York,117533,118287,754,0.642
Wayne County,Georgia,30144,30896,752,2.495
Muskegon County,Michigan,175814,176565,751,0.427
Chaffee County,Colorado,19473,20223,750,3.851
Arapahoe County,Colorado,655058,655808,750,0.114
Grainger County,Tennessee,23527,24277,750,3.188
Lebanon County,Pennsylvania,143262,144011,749,0.523
Pacific County,Washington,23365,24113,748,3.201
Jefferson County,Montana,12081,12826,745,6.167
Cherokee County,North Carolina,28769,29512,743,2.583
Elmore County,Idaho,28665,29403,738,2.575
Camden County,North Carolina,10357,11088,731,7.058
Polk County,Wisconsin,44979,45709,730,1.623
Lincoln County,Oklahoma,33460,34188,728,2.176
Lincoln County,Washington,10879,11601,722,6.637
Boise County,Idaho,7613,8333,720,9.458
Valley County,Idaho,11744,12464,720,6.131
Vilas County,Wisconsin,23047,23763,716,3.107
Warren County,Virginia,40724,41440,716,1.758
St. Bernard Parish,Louisiana,43766,44479,713,1.629
Allegan County,Michigan,120499,121210,711,0.59
Carbon County,Pennsylvania,64750,65460,710,1.097
White County,Tennessee,27356,28064,708,2.588
Greene County,Arkansas,45740,46448,708,1.548
Angelina County,Texas,86394,87101,707,0.818
Franklin County,Georgia,23424,24128,704,3.005
Carbon County,Montana,10476,11179,703,6.711
Owyhee County,Idaho,11914,12613,699,5.867
Allen County,Kentucky,20580,21275,695,3.377
Sagadahoc County,Maine,36699,37393,694,1.891
Rockland County,New York,338329,339022,693,0.205
Lawrence County,Missouri,37995,38683,688,1.811
Fairfax city,Virginia,24148,24835,687,2.845
Custer County,South Dakota,8319,9006,687,8.258
Fremont County,Colorado,48938,49621,683,1.396
King William County,Virginia,17811,18492,681,3.823
Pope County,Arkansas,63385,64065,680,1.073
Champaign County,Illinois,205863,206542,679,0.33
Lincoln County,Tennessee,35326,36004,678,1.919
Tipton County,Tennessee,60979,61656,677,1.11
Miller County,Missouri,24726,25403,677,2.738
Phelps County,Missouri,44640,45313,673,1.508
Summit County,Utah,42364,43036,672,1.586
Webb County,Texas,267110,267780,670,0.251
Radford city,Virginia,16068,16738,670,4.17
Rains County,Texas,12154,12823,669,5.504
Hamblen County,Tennessee,64500,65168,668,1.036
Douglas County,Minnesota,39002,39668,666,1.708
Oconto County,Wisconsin,38971,39633,662,1.699
Miami County,Kansas,34205,34867,662,1.935
Polk County,North Carolina,19330,19986,656,3.394
Nelson County,Kentucky,46737,47392,655,1.401
Stokes County,North Carolina,44523,45175,652,1.464
Union County,Tennessee,19802,20452,650,3.282
Gila County,Arizona,53273,53922,649,1.218
Archuleta County,Colorado,13356,14003,647,4.844
Oglethorpe County,Georgia,14824,15469,645,4.351
Waldo County,Maine,39596,40241,645,1.629
Clallam County,Washington,77160,77805,645,0.836
Marquette County,Michigan,66020,66661,641,0.971
Garrard County,Kentucky,16949,17589,640,3.776
Madison County,Montana,8626,9265,639,7.408
Custer County,Colorado,4703,5335,632,13.438
Appomattox County,Virginia,16117,16748,631,3.915
Somerset County,Maine,50472,51098,626,1.24
Clinton County,Michigan,79123,79748,625,0.79
Wichita County,Texas,129355,129978,623,0.482
Montezuma County,Colorado,25846,26468,622,2.407
Clay County,Minnesota,65309,65929,620,0.949
Piscataquis County,Maine,16799,17417,618,3.679
Clatsop County,Oregon,41078,41695,617,1.502
Jefferson County,Washington,32975,33589,614,1.862
Waynesboro city,Virginia,22195,22808,613,2.762
Minidoka County,Idaho,21582,22194,612,2.836
Hubbard County,Minnesota,21348,21960,612,2.867
Franklin County,Virginia,54475,55074,599,1.1
Park County,Montana,17193,17790,597,3.472
Rice County,Minnesota,67098,67693,595,0.887
Fremont County,Idaho,13383,13978,595,4.446
Blaine County,Idaho,24275,24866,591,2.435
Washington County,Idaho,10500,11087,587,5.59
Calloway County,Kentucky,37098,37685,587,1.582
Garfield County,Colorado,61688,62271,583,0.945
Gaines County,Texas,21599,22181,582,2.695
Glynn County,Georgia,84497,85079,582,0.689
Adams County,Wisconsin,20646,21226,580,2.809
Augusta County,Virginia,77485,78064,579,0.747
Kosciusko County,Indiana,80247,80826,579,0.722
Cleburne County,Arkansas,24705,25284,579,2.344
Marshall County,Oklahoma,15303,15882,579,3.784
Madison County,North Carolina,21192,21768,576,2.718
Smith County,Tennessee,19914,20489,575,2.887
Peach County,Georgia,27989,28562,573,2.047
Putnam County,Indiana,36728,37301,573,1.56
Beltrami County,Minnesota,46230,46799,569,1.231
Leelanau County,Michigan,22304,22870,566,2.538
Kane County,Utah,7663,8227,564,7.36
Pine County,Minnesota,28883,29446,563,1.949
Duchesne County,Utah,19603,20161,558,2.847
Orange County,Vermont,29289,29846,557,1.902
Grant County,Kentucky,24946,25502,556,2.229
Knox County,Maine,40608,41164,556,1.369
Dallas County,Missouri,17070,17626,556,3.257
Greene County,Virginia,20554,21107,553,2.69
Somervell County,Texas,9204,9757,553,6.008
Sevier County,Utah,21517,22069,552,2.565
Otsego County,Michigan,25095,25644,549,2.188
Hickman County,Tennessee,24909,25455,546,2.192
Mayes County,Oklahoma,39044,39589,545,1.396
Park County,Colorado,17395,17939,544,3.127
Botetourt County,Virginia,33593,34135,542,1.613
Bossier Parish,Louisiana,128736,129276,540,0.419
Morgan County,Utah,12294,12832,538,4.376
Klickitat County,Washington,22734,23271,537,2.362
Butte County,South Dakota,10238,10774,536,5.235
Jefferson County,Florida,14507,15042,535,3.688
Overton County,Tennessee,22514,23044,530,2.354
Sharp County,Arkansas,17280,17810,530,3.067
Mineral County,Montana,4529,5058,529,11.68
Clay County,North Carolina,11085,11614,529,4.772
Ashe County,North Carolina,26581,27110,529,1.99
Wexford County,Michigan,33668,34196,528,1.568
Newberry County,South Carolina,37722,38247,525,1.392
Cass County,Nebraska,26598,27122,524,1.97
Rutherford County,North Carolina,64444,64963,519,0.805
Meigs County,Tennessee,12755,13272,517,4.053
Kauai County,Hawaii,73294,73810,516,0.704
Haywood County,North Carolina,62097,62609,512,0.825
Breckinridge County,Kentucky,20433,20943,510,2.496
Burnett County,Wisconsin,16526,17036,510,3.086
Randolph County,Alabama,21970,22479,509,2.317
Henry County,Alabama,17148,17655,507,2.957
Carlton County,Minnesota,36201,36708,507,1.401
Callahan County,Texas,13703,14210,507,3.7
McIntosh County,Oklahoma,18944,19451,507,2.676
Carter County,Oklahoma,48004,48510,506,1.054
Chippewa County,Wisconsin,66302,66807,505,0.762
Yamhill County,Oregon,107721,108226,505,0.469
Freestone County,Texas,19445,19950,505,2.597
Blue Earth County,Minnesota,69129,69631,502,0.726
Trousdale County,Tennessee,11610,12111,501,4.315
Grundy County,Illinois,52544,53041,497,0.946
Crawford County,Michigan,12994,13491,497,3.825
Buffalo County,Nebraska,50089,50586,497,0.992
Williamsburg city,Virginia,15413,15909,496,3.218
Clare County,Michigan,30857,31352,495,1.604
Washington County,Rhode Island,129836,130330,494,0.38
Lake County,Michigan,12100,12594,494,4.083
Kings County,California,152488,152981,493,0.323
Henry County,Missouri,21946,22438,492,2.242
Leon County,Texas,15717,16209,492,3.13
Madison County,Iowa,16545,17036,491,2.968
Murray County,Georgia,39982,40472,490,1.226
Monmouth County,New Jersey,643608,644098,490,0.076
Towns County,Georgia,12487,12972,485,3.884
Greene County,Ohio,167971,168456,485,0.289
Carroll County,Arkansas,28260,28742,482,1.706
Le Sueur County,Minnesota,28672,29153,481,1.678
Lee County,Georgia,33162,33642,480,1.447
Clarke County,Virginia,14787,15266,479,3.239
Sawyer County,Wisconsin,18080,18559,479,2.649
Fayette County,Texas,24436,24913,477,1.952
Clinton County,Pennsylvania,37456,37931,475,1.268
Izard County,Arkansas,13574,14048,474,3.492
Lee County,Texas,17480,17954,474,2.712
Waushara County,Wisconsin,24526,24999,473,1.929
Knox County,Ohio,62711,63183,472,0.753
Callaway County,Missouri,44290,44762,472,1.066
Bosque County,Texas,18226,18697,471,2.584
Musselshell County,Montana,4732,5197,465,9.827
Northumberland County,Virginia,11838,12302,464,3.92
Ulster County,New York,181856,182319,463,0.255
Door County,Wisconsin,30066,30526,460,1.53
DeKalb County,Indiana,43273,43731,458,1.058
Dearborn County,Indiana,50680,51138,458,0.904
Pierce County,Georgia,19716,20168,452,2.293
Morgan County,Indiana,71785,72236,451,0.628
Cascade County,Montana,84413,84864,451,0.534
Jack County,Texas,8474,8922,448,5.287
Garza County,Texas,5816,6262,446,7.669
Otter Tail County,Minnesota,60074,60519,445,0.741
Logan County,Kentucky,27433,27877,444,1.618
Delaware County,New York,44302,44740,438,0.989
Whitley County,Indiana,34190,34627,437,1.278
Adams County,Idaho,4380,4817,437,9.977
Kanabec County,Minnesota,16027,16463,436,2.72
Goodhue County,Minnesota,47580,48013,433,0.91
Laurens County,South Carolina,67533,67965,432,0.64
Gibson County,Tennessee,50409,50837,428,0.849
Skamania County,Washington,12033,12460,427,3.549
Morton County,North Dakota,33287,33710,423,1.271
Aitkin County,Minnesota,15703,16126,423,2.694
Marion County,Arkansas,16832,17254,422,2.507
LaGrange County,Indiana,40444,40866,422,1.043
Lyon County,Kentucky,8683,9101,418,4.814
Fannin County,Georgia,25319,25737,418,1.651
Montmorency County,Michigan,9154,9569,415,4.534
Cedar County,Missouri,14187,14601,414,2.918
Lincoln County,Oregon,50400,50813,413,0.819
Chesterfield County,South Carolina,43270,43683,413,0.954
Talbot County,Maryland,37520,37932,412,1.098
Harrison County,Kentucky,18692,19103,411,2.199
Torrance County,New Mexico,15045,15454,409,2.719
Delta County,Colorado,31199,31602,403,1.292
Lamar County,Texas,50082,50484,402,0.803
Madison County,Tennessee,98843,99245,402,0.407
Douglas County,Missouri,11575,11975,400,3.456
Morrow County,Ohio,34940,35339,399,1.142
Fall River County,South Dakota,6971,7370,399,5.724
Sevier County,Tennessee,98391,98789,398,0.405
Codington County,South Dakota,28323,28721,398,1.405
Trinity County,Texas,13600,13996,396,2.912
Morgan County,Kentucky,13724,14120,396,2.885
Bayfield County,Wisconsin,16213,16608,395,2.436
Will County,Illinois,696362,696757,395,0.057
Robertson County,Texas,16759,17153,394,2.351
Claiborne County,Tennessee,32038,32431,393,1.227
Barry County,Missouri,34533,34926,393,1.138
Windsor County,Vermont,57751,58142,391,0.677
Taylor County,Kentucky,26019,26407,388,1.491
Upson County,Georgia,27699,28086,387,1.397
Sequoyah County,Oklahoma,39280,39667,387,0.985
DeKalb County,Alabama,71611,71998,387,0.54
Richland County,Ohio,124933,125319,386,0.309
Osceola County,Michigan,22890,23274,384,1.678
Ozark County,Missouri,8556,8940,384,4.488
Blount County,Alabama,59130,59512,382,0.646
Presque Isle County,Michigan,12981,13361,380,2.927
Lewis County,Tennessee,12581,12957,376,2.989
Hampshire County,West Virginia,23092,23468,376,1.628
Uvalde County,Texas,24564,24940,376,1.531
Stewart County,Tennessee,13662,14035,373,2.73
Anderson County,Kentucky,23851,24224,373,1.564
Barren County,Kentucky,44482,44854,372,0.836
Pasquotank County,North Carolina,40568,40938,370,0.912
Jackson County,Tennessee,11619,11989,370,3.184
Pettis County,Missouri,42984,43353,369,0.858
Jasper County,Indiana,32912,33281,369,1.121
Transylvania County,North Carolina,32986,33355,369,1.119
Rock County,Wisconsin,163692,164060,368,0.225
Cape May County,New Jersey,95266,95634,368,0.386
Dixie County,Florida,16758,17124,366,2.184
Oneida County,Wisconsin,37848,38212,364,0.962
Morgan County,West Virginia,17067,17430,363,2.127
Putnam County,New York,97682,98045,363,0.372
Johnson County,Missouri,54007,54368,361,0.668
Marshall County,Mississippi,33755,34110,355,1.052
Washington County,Texas,35804,36159,355,0.992
Cheboygan County,Michigan,25586,25940,354,1.384
Simpson County,Kentucky,19595,19949,354,1.807
Millard County,Utah,12977,13330,353,2.72
Hickory County,Missouri,8277,8630,353,4.265
Bear Lake County,Idaho,6371,6722,351,5.509
Gunnison County,Colorado,16917,17267,350,2.069
Washington County,Maine,31088,31437,349,1.123
Adams County,Washington,20612,20961,349,1.693
Mason County,Michigan,29063,29409,346,1.191
Schoharie County,New York,29718,30063,345,1.161
Beaverhead County,Montana,9374,9719,345,3.68
Vernon County,Wisconsin,30715,31060,345,1.123
Caledonia County,Vermont,30235,30579,344,1.138
Union County,Mississippi,27782,28125,343,1.235
Elko County,Nevada,53703,54046,343,0.639
Portage County,Wisconsin,70376,70718,342,0.486
Gladwin County,Michigan,25386,25728,342,1.347
Yancey County,North Carolina,18470,18811,341,1.846
Conway County,Arkansas,20709,21046,337,1.627
Big Horn County,Wyoming,11521,11855,334,2.899
Stone County,Mississippi,18336,18669,333,1.816
Montgomery County,Indiana,37941,38273,332,0.875
Pierce County,Wisconsin,42205,42532,327,0.775
Luna County,New Mexico,25422,25749,327,1.286
Churchill County,Nevada,25516,25843,327,1.282
Glades County,Florida,12127,12454,327,2.696
Benzie County,Michigan,17973,18297,324,1.803
Dickinson County,Iowa,17704,18028,324,1.83
Rabun County,Georgia,16882,17206,324,1.919
Cherokee County,Alabama,24979,25302,323,1.293
Hart County,Kentucky,19281,19600,319,1.654
Hardee County,Florida,25326,25645,319,1.26
Middlesex County,Virginia,10626,10943,317,2.983
Polk County,Tennessee,17547,17863,316,1.801
Oceana County,Michigan,26658,26973,315,1.182
Clay County,South Dakota,14966,15280,314,2.098
Heard County,Georgia,11414,11725,311,2.725
Jackson County,Alabama,52582,52891,309,0.588
Burke County,North Carolina,87573,87881,308,0.352
Campbell County,Tennessee,39277,39584,307,0.782
Van Buren County,Arkansas,15797,16102,305,1.931
Fulton County,Arkansas,12077,12382,305,2.525
Perry County,Tennessee,8381,8685,304,3.627
Malheur County,Oregon,31575,31879,304,0.963
Washington County,Nebraska,20865,21167,302,1.447
Alleghany County,North Carolina,10886,11185,299,2.747
DeKalb County,Missouri,11039,11336,297,2.69
Larue County,Kentucky,14869,15163,294,1.977
Person County,North Carolina,39093,39386,293,0.749
Iosco County,Michigan,25230,25521,291,1.153
Lanier County,Georgia,9880,10171,291,2.945
Otoe County,Nebraska,15907,16198,291,1.829
Cleburne County,Alabama,15057,15346,289,1.919
Washburn County,Wisconsin,16622,16911,289,1.739
St. Clair County,Missouri,9287,9576,289,3.112
Comanche County,Texas,13590,13878,288,2.119
Stephens County,Texas,9104,9390,286,3.141
Boyle County,Kentucky,30619,30904,285,0.931
Duplin County,North Carolina,48705,48990,285,0.585
Todd County,Minnesota,25253,25538,285,1.129
Calumet County,Wisconsin,52433,52718,285,0.544
Okmulgee County,Oklahoma,36706,36990,284,0.774
Clearwater County,Idaho,8731,9015,284,3.253
Hampshire County,Massachusetts,162305,162588,283,0.174
Salem County,New Jersey,64834,65117,283,0.436
Jones County,Texas,19653,19935,282,1.435
Yakima County,Washington,256719,257001,282,0.11
Archer County,Texas,8554,8835,281,3.285
McDonald County,Missouri,23308,23588,280,1.201
Lynchburg city,Virginia,79007,79287,280,0.354
Johnson County,Wyoming,8451,8730,279,3.301
Wabasha County,Minnesota,21380,21658,278,1.3
Amherst County,Virginia,31311,31589,278,0.888
Steuben County,Indiana,34448,34725,277,0.804
Perry County,Pennsylvania,45837,46114,277,0.604
Emery County,Utah,9822,10099,277,2.82
Cannon County,Tennessee,14512,14788,276,1.902
Trigg County,Kentucky,14057,14332,275,1.956
Dukes County,Massachusetts,20595,20868,273,1.326
Moore County,Tennessee,6469,6742,273,4.22
Clay County,Texas,10213,10486,273,2.673
Nicholas County,Kentucky,7532,7805,273,3.625
Laurel County,Kentucky,62613,62885,272,0.434
Wallowa County,Oregon,7387,7659,272,3.682
Baker County,Oregon,16666,16938,272,1.632
Brown County,Texas,38101,38373,272,0.714
Bremer County,Iowa,24988,25259,271,1.085
Laclede County,Missouri,36042,36313,271,0.752
Ferry County,Washington,7178,7448,270,3.761
Wahkiakum County,Washington,4419,4688,269,6.087
Lafayette County,Wisconsin,16608,16877,269,1.62
Randolph County,Arkansas,18571,18837,266,1.432
Uinta County,Wyoming,20446,20712,266,1.301
Huerfano County,Colorado,6816,7082,266,3.903
Whitfield County,Georgia,102866,103132,266,0.259
Lemhi County,Idaho,7976,8240,264,3.31
Crook County,Wyoming,7184,7448,264,3.675
Orleans County,Vermont,27402,27666,264,0.963
Charlton County,Georgia,12518,12781,263,2.101
Montgomery County,Kentucky,28104,28367,263,0.936
Centre County,Pennsylvania,158163,158425,262,0.166
Van Buren County,Tennessee,6168,6429,261,4.232
Chester County,Tennessee,17348,17609,261,1.504
Franklin County,Texas,10357,10618,261,2.52
Marion County,Tennessee,28835,29094,259,0.898
Mercer County,Kentucky,22643,22902,259,1.144
Manistee County,Michigan,25029,25287,258,1.031
Grundy County,Tennessee,13525,13783,258,1.908
Roscommon County,Michigan,23450,23708,258,1.1
Adams County,Indiana,35811,36068,257,0.718
Green County,Kentucky,11109,11365,256,2.304
Kalkaska County,Michigan,17928,18182,254,1.417
Beaver County,Utah,7074,7327,253,3.576
Switzerland County,Indiana,9753,10006,253,2.594
Johnson County,Arkansas,25749,26001,252,0.979
Lavaca County,Texas,20337,20589,252,1.239
Yadkin County,North Carolina,37211,37463,252,0.677
Camp County,Texas,12465,12716,251,2.014
Saguache County,Colorado,6372,6623,251,3.939
Carroll County,Indiana,20304,20555,251,1.236
Alcona County,Michigan,10167,10417,250,2.459
Union County,South Dakota,16813,17063,250,1.487
Wharton County,Texas,41574,41824,250,0.601
Ontario County,New York,112459,112707,248,0.221
Allegany County,New York,46446,46694,248,0.534
Hardin County,Tennessee,26829,27077,248,0.924
Graham County,Arizona,38533,38779,246,0.638
Lyon County,Iowa,11934,12179,245,2.053
Catron County,New Mexico,3582,3827,245,6.84
Washington County,Vermont,59804,60048,244,0.408
Charlevoix County,Michigan,26051,26293,242,0.929
Coos County,New Hampshire,31262,31504,242,0.774
Wadena County,Minnesota,14065,14307,242,1.721
McCormick County,South Carolina,9522,9764,242,2.541
Floyd County,Indiana,80474,80714,240,0.298
Martinsville city,Virginia,13486,13725,239,1.772
Fremont County,Wyoming,39234,39472,238,0.607
Morrison County,Minnesota,34010,34246,236,0.694
Marshall County,Indiana,46096,46332,236,0.512
Chowan County,North Carolina,13705,13940,235,1.715
Meriwether County,Georgia,20610,20845,235,1.14
Westmoreland County,Virginia,18477,18712,235,1.272
Lewis County,Idaho,3528,3763,235,6.661
Custer County,Idaho,4274,4506,232,5.428
Franklin County,Indiana,22796,23028,232,1.018
Tyler County,Texas,19799,20030,231,1.167
Tate County,Mississippi,28066,28296,230,0.819
Noble County,Ohio,14106,14335,229,1.623
Madison County,Florida,17970,18198,228,1.269
Lake County,Oregon,8158,8385,227,2.783
York County,Nebraska,14128,14354,226,1.6
Hudspeth County,Texas,3206,3432,226,7.049
Marion County,Iowa,33417,33642,225,0.673
Campbell County,Kentucky,93075,93300,225,0.242
Dale County,Alabama,49319,49544,225,0.456
Beadle County,South Dakota,19153,19376,223,1.164
Dinwiddie County,Virginia,27940,28161,221,0.791
Asotin County,Washington,22288,22508,220,0.987
Ouray County,Colorado,4880,5100,220,4.508
Fergus County,Montana,11443,11663,220,1.923
Addison County,Vermont,37359,37578,219,0.586
Christian County,Kentucky,72818,73037,219,0.301
Stillwater County,Montana,8959,9177,218,2.433
Stone County,Arkansas,12358,12575,217,1.756
Laramie County,Wyoming,100506,100723,217,0.216
Dunn County,Wisconsin,45434,45651,217,0.478
Southeast Fairbanks Census Area,Alaska,6805,7021,216,3.174
Parke County,Indiana,16154,16369,215,1.331
Cochise County,Arizona,125448,125663,215,0.171
Grayson County,Kentucky,26418,26631,213,0.806
Alamosa County,Colorado,16381,16592,211,1.288
Nacogdoches County,Texas,64651,64862,211,0.326
Winston County,Alabama,23544,23755,211,0.896
Eastland County,Texas,17733,17944,211,1.19
Giles County,Tennessee,30344,30554,210,0.692
Lawrence County,Indiana,45015,45222,207,0.46
Lincoln County,Idaho,5123,5329,206,4.021
Pawnee County,Oklahoma,15551,15757,206,1.325
Scott County,Indiana,24383,24588,205,0.841
McIntosh County,Georgia,10975,11180,205,1.868
Forest County,Wisconsin,9176,9381,205,2.234
Linn County,Kansas,9591,9796,205,2.137
Perquimans County,North Carolina,13006,13210,204,1.569
Jones County,Iowa,20646,20848,202,0.978
Fleming County,Kentucky,15086,15288,202,1.339
Harrison County,Indiana,39649,39851,202,0.509
Columbia County,Pennsylvania,64725,64926,201,0.311
Greene County,Indiana,30805,31006,201,0.652
Ogemaw County,Michigan,20769,20970,201,0.968
Rockcastle County,Kentucky,16042,16242,200,1.247
Colorado County,Texas,20555,20754,199,0.968
Marion County,Kentucky,19577,19775,198,1.011
Madison County,Texas,13463,13661,198,1.471
Grand Isle County,Vermont,7291,7489,198,2.716
Green Lake County,Wisconsin,19023,19220,197,1.036
Pontotoc County,Mississippi,31192,31389,197,0.632
Morgan County,Tennessee,21027,21224,197,0.937
Dorchester County,Maryland,32530,32726,196,0.603
Granite County,Montana,3306,3502,196,5.929
Becker County,Minnesota,35176,35371,195,0.554
Turner County,South Dakota,8662,8856,194,2.24
Grant County,Arkansas,17966,18160,194,1.08
Power County,Idaho,7874,8068,194,2.464
Mecklenburg County,Virginia,30315,30508,193,0.637
Hamlin County,South Dakota,6159,6352,193,3.134
Amelia County,Virginia,13262,13455,193,1.455
Garfield County,Utah,5092,5281,189,3.712
Russell County,Kentucky,17990,18178,188,1.045
Woodford County,Kentucky,26874,27062,188,0.7
Mitchell County,North Carolina,14906,15094,188,1.261
Itasca County,Minnesota,45018,45205,187,0.415
Hancock County,Tennessee,6659,6845,186,2.793
Fillmore County,Minnesota,21229,21414,185,0.871
Panola County,Texas,22492,22677,185,0.823
Latimer County,Oklahoma,9446,9630,184,1.948
Ohio County,Indiana,5930,6114,184,3.103
Routt County,Colorado,24824,25007,183,0.737
Marquette County,Wisconsin,15596,15779,183,1.173
Scott County,Tennessee,21852,22035,183,0.837
Henry County,Tennessee,32197,32379,182,0.565
Delta County,Texas,5225,5406,181,3.464
Tillamook County,Oregon,27393,27574,181,0.661
Sioux County,Iowa,35870,36050,180,0.502
Oscoda County,Michigan,8225,8404,179,2.176
Salem city,Virginia,25347,25523,176,0.694
McDowell County,North Carolina,44577,44753,176,0.395
Midland County,Michigan,83498,83674,176,0.211
Elbert County,Georgia,19638,19814,176,0.896
Gonzales County,Texas,19657,19832,175,0.89
Cook County,Georgia,17230,17404,174,1.01
Pondera County,Montana,5905,6078,173,2.93
Wayne County,Nebraska,9698,9871,173,1.784
Holmes County,Ohio,44217,44390,173,0.391
Franklin County,Arkansas,17101,17271,170,0.994
Nantucket County,Massachusetts,14251,14421,170,1.193
McLean County,Illinois,170975,171141,166,0.097
Shannon County,Missouri,7027,7193,166,2.362
Missaukee County,Michigan,15048,15213,165,1.096
Ste. Genevieve County,Missouri,18479,18644,165,0.893
Custer County,Montana,11867,12032,165,1.39
Lapeer County,Michigan,88615,88780,165,0.186
Huntington County,Indiana,36670,36834,164,0.447
Coleman County,Texas,7686,7850,164,2.134
Adair County,Kentucky,18903,19067,164,0.868
Brantley County,Georgia,18021,18183,162,0.899
Caribou County,Idaho,7028,7190,162,2.305
Nowata County,Oklahoma,9322,9483,161,1.727
Weakley County,Tennessee,32902,33063,161,0.489
Richmond County,Virginia,8920,9080,160,1.794
Emanuel County,Georgia,22769,22929,160,0.703
Madison County,Virginia,13842,14000,158,1.141
Whitley County,Kentucky,36715,36873,158,0.43
Hot Spring County,Arkansas,33046,33203,157,0.475
Iowa County,Wisconsin,23709,23865,156,0.658
Craven County,North Carolina,100718,100874,156,0.155
Owen County,Indiana,21326,21482,156,0.732
Sabine County,Texas,9892,10048,156,1.577
Jackson County,Texas,14987,15142,155,1.034
Todd County,Kentucky,12249,12404,155,1.265
Choctaw County,Oklahoma,14203,14358,155,1.091
Wayne County,Utah,2490,2645,155,6.225
Walworth County,Wisconsin,105226,105380,154,0.146
Lincoln County,Georgia,7688,7841,153,1.99
Carbon County,Utah,20418,20571,153,0.749
Spencer County,Indiana,19814,19967,153,0.772
Buckingham County,Virginia,16830,16982,152,0.903
Rappahannock County,Virginia,7350,7502,152,2.068
Montgomery County,Missouri,11319,11470,151,1.334
Lamoille County,Vermont,25939,26090,151,0.582
Curry County,Oregon,23447,23598,151,0.644
Anson County,North Carolina,22052,22202,150,0.68
Staunton city,Virginia,25754,25904,150,0.582
Buchanan County,Iowa,20565,20714,149,0.725
Oneida County,Idaho,4563,4712,149,3.265
Wells County,Indiana,28187,28335,148,0.525
Aroostook County,Maine,67107,67255,148,0.221
Umatilla County,Oregon,80068,80215,147,0.184
Wabaunsee County,Kansas,6872,7019,147,2.139
Robeson County,North Carolina,116516,116663,147,0.126
Clinton County,Missouri,21182,21328,146,0.689
Teller County,Colorado,24711,24857,146,0.591
Bates County,Missouri,16032,16177,145,0.904
Juneau County,Wisconsin,26721,26866,145,0.543
Douglas County,Nevada,49484,49628,144,0.291
Floyd County,Virginia,15475,15619,144,0.931
Childress County,Texas,6666,6809,143,2.145
Trempealeau County,Wisconsin,30756,30899,143,0.465
Montgomery County,North Carolina,25752,25894,142,0.551
Kimble County,Texas,4280,4422,142,3.318
Anderson County,Texas,57922,58064,142,0.245
Lexington city,Virginia,7317,7457,140,1.913
Benton County,Iowa,25571,25711,140,0.547
Schoolcraft County,Michigan,8049,8188,139,1.727
Benton County,Tennessee,15863,16002,139,0.876
Lincoln County,New Mexico,20273,20411,138,0.681
Teton County,Montana,6230,6368,138,2.215
Lawrence County,Alabama,33077,33214,137,0.414
Edmonson County,Kentucky,12133,12269,136,1.121
Menifee County,Kentucky,6114,6250,136,2.224
Johnson County,Tennessee,17950,18086,136,0.758
Barron County,Wisconsin,46709,46843,134,0.287
Caroline County,Maryland,33299,33433,134,0.402
Morgan County,Colorado,29106,29239,133,0.457
Florence County,Wisconsin,4555,4688,133,2.92
Bourbon County,Kansas,14361,14493,132,0.919
Johnston County,Oklahoma,10276,10406,130,1.265
Carroll County,Kentucky,10809,10938,129,1.193
Lynn County,Texas,5595,5724,129,2.306
Jasper County,Iowa,37809,37938,129,0.341
Karnes County,Texas,14707,14836,129,0.877
McNairy County,Tennessee,25859,25988,129,0.499
Dolores County,Colorado,2326,2455,129,5.546
Greene County,New York,47933,48061,128,0.267
Orange County,Texas,84806,84934,128,0.151
Clearwater County,Minnesota,8521,8649,128,1.502
Baraga County,Michigan,8149,8277,128,1.571
Poquoson city,Virginia,12455,12582,127,1.02
Atoka County,Oklahoma,14135,14262,127,0.898
Pulaski County,Georgia,9857,9984,127,1.288
Madison County,Missouri,12627,12753,126,0.998
Keweenaw County,Michigan,2055,2180,125,6.083
Kent County,Maryland,19195,19320,125,0.651
Price County,Wisconsin,14055,14179,124,0.882
Prince George County,Virginia,43010,43134,124,0.288
Geneva County,Alabama,26660,26783,123,0.461
Colonial Heights city,Virginia,18171,18294,123,0.677
Delaware County,Indiana,111909,112031,122,0.109
McCurtain County,Oklahoma,30809,30931,122,0.396
Wayne County,Kentucky,19559,19681,122,0.624
Pope County,Minnesota,11309,11431,122,1.079
Decatur County,Tennessee,11442,11564,122,1.066
Jones County,Georgia,28351,28472,121,0.427
Logan County,Arkansas,21132,21253,121,0.573
Dallam County,Texas,7121,7241,120,1.685
Caldwell County,Missouri,8813,8933,120,1.362
Lewis County,New York,26580,26699,119,0.448
Rich County,Utah,2510,2628,118,4.701
Tyrrell County,North Carolina,3247,3365,118,3.634
Osage County,Missouri,13281,13399,118,0.888
Marshall County,Kentucky,31661,31777,116,0.366
Gooding County,Idaho,15599,15715,116,0.744
Frontier County,Nebraska,2519,2633,114,4.526
Polk County,Arkansas,19223,19337,114,0.593
Humphreys County,Tennessee,18992,19106,114,0.6
Marinette County,Wisconsin,41874,41988,114,0.272
Sibley County,Minnesota,14842,14955,113,0.761
Morrow County,Oregon,12187,12300,113,0.927
Goliad County,Texas,7018,7131,113,1.61
King and Queen County,Virginia,6606,6718,112,1.695
Morris County,Texas,11971,12083,112,0.936
Conejos County,Colorado,7467,7579,112,1.5
Jeff Davis County,Georgia,14778,14889,111,0.751
Mackinac County,Michigan,10831,10941,110,1.016
Kingsbury County,South Dakota,5184,5294,110,2.122
Clarion County,Pennsylvania,37236,37346,110,0.295
Cook County,Minnesota,5599,5708,109,1.947
Toole County,Montana,4973,5082,109,2.192
Butte County,Idaho,2575,2684,109,4.233
Dodge County,Minnesota,20873,20981,108,0.517
Throckmorton County,Texas,1442,1550,108,7.49
Powell County,Montana,6944,7051,107,1.541
Pamlico County,North Carolina,12274,12381,107,0.872
Costilla County,Colorado,3496,3603,107,3.061
Mower County,Minnesota,40034,40140,106,0.265
Kandiyohi County,Minnesota,43733,43839,106,0.242
Limestone County,Texas,22147,22253,106,0.479
Lake of the Woods County,Minnesota,3765,3871,106,2.815
Kingfisher County,Oklahoma,15187,15293,106,0.698
San Saba County,Texas,5720,5824,104,1.818
Ripley County,Indiana,28984,29087,103,0.355
Crawford County,Kansas,38976,39078,102,0.262
Pickett County,Tennessee,5006,5107,101,2.018
Fountain County,Indiana,16474,16574,100,0.607
Grand County,Utah,9669,9769,100,1.034
San Juan County,Colorado,703,803,100,14.225
Van Buren County,Michigan,75593,75692,99,0.131
Montgomery County,New York,49526,49623,97,0.196
McCook County,South Dakota,5682,5778,96,1.69
Meeker County,Minnesota,23400,23496,96,0.41
Live Oak County,Texas,11333,11428,95,0.838
Brown County,Indiana,15475,15570,95,0.614
Young County,Texas,17867,17962,95,0.532
Cass County,Texas,28445,28539,94,0.33
Lunenburg County,Virginia,11937,12031,94,0.787
Clay County,Iowa,16381,16475,94,0.574
Washington County,Florida,25322,25414,92,0.363
Taos County,New Mexico,34488,34580,92,0.267
Oregon County,Missouri,8641,8732,91,1.053
Dade County,Missouri,7571,7660,89,1.176
Henry County,Kentucky,15682,15771,89,0.568
Real County,Texas,2751,2840,89,3.235
Henderson County,Tennessee,27841,27929,88,0.316
Gentry County,Missouri,6165,6253,88,1.427
Sherman County,Oregon,1867,1955,88,4.713
McDuffie County,Georgia,21625,21713,88,0.407
Meagher County,Montana,1926,2013,87,4.517
Searcy County,Arkansas,7831,7918,87,1.111
Iron County,Wisconsin,6138,6224,86,1.401
Deer Lodge County,Montana,9424,9510,86,0.913
Falls County,Texas,16963,17049,86,0.507
Sanborn County,South Dakota,2330,2415,85,3.648
Edmunds County,South Dakota,3981,4065,84,2.11
Lincoln County,Kentucky,24276,24360,84,0.346
Seward County,Nebraska,17608,17692,84,0.477
Coffee County,Georgia,43088,43172,84,0.195
Delaware County,Iowa,17484,17568,84,0.48
Shackelford County,Texas,3102,3186,84,2.708
Judith Basin County,Montana,2021,2105,84,4.156
Pepin County,Wisconsin,7326,7410,84,1.147
Brown County,Illinois,6247,6330,83,1.329
Clark County,Missouri,6640,6723,83,1.25
Adair County,Oklahoma,19494,19576,82,0.421
Arenac County,Michigan,15007,15089,82,0.546
Benton County,Minnesota,41381,41463,82,0.198
Bath County,Kentucky,12747,12829,82,0.643
Metcalfe County,Kentucky,10288,10370,82,0.797
Gilpin County,Colorado,5810,5891,81,1.394
Prince Edward County,Virginia,21846,21927,81,0.371
Sumner County,Kansas,22392,22473,81,0.362
Harrison County,Iowa,14578,14658,80,0.549
Monroe County,Illinois,34953,35033,80,0.229
Sampson County,North Carolina,59040,59120,80,0.136
Camas County,Idaho,1073,1153,80,7.456
Haskell County,Oklahoma,11562,11641,79,0.683
Laurens County,Georgia,49581,49660,79,0.159
Buffalo County,Wisconsin,13312,13391,79,0.593
Saluda County,South Carolina,18859,18938,79,0.419
Donley County,Texas,3261,3339,78,2.392
Daggett County,Utah,936,1014,78,8.333
Hamilton County,Texas,8221,8298,77,0.937
Colusa County,California,21837,21914,77,0.353
Pontotoc County,Oklahoma,38065,38141,76,0.2
Wayne County,Tennessee,16232,16308,76,0.468
Essex County,Vermont,5919,5994,75,1.267
Gray County,Kansas,5654,5729,75,1.326
Garfield County,Washington,2288,2363,75,3.278
Columbia County,Washington,3952,4026,74,1.872
Highland County,Ohio,43317,43391,74,0.171
West Feliciana Parish,Louisiana,15307,15381,74,0.483
Pike County,Missouri,17590,17664,74,0.421
Billings County,North Dakota,945,1018,73,7.725
Love County,Oklahoma,10146,10218,72,0.71
Alexander County,North Carolina,36440,36512,72,0.198
Storey County,Nevada,4098,4170,72,1.757
Perry County,Ohio,35409,35480,71,0.201
Brunswick County,Virginia,15850,15921,71,0.448
Warren County,North Carolina,18642,18713,71,0.381
Livingston County,Kentucky,8892,8963,71,0.798
Johnson County,Illinois,13310,13381,71,0.533
Montgomery County,Arkansas,8486,8556,70,0.825
Hood River County,Oregon,23978,24048,70,0.292
Gallatin County,Kentucky,8693,8763,70,0.805
Union County,Pennsylvania,42675,42744,69,0.162
Webster County,Mississippi,9924,9993,69,0.695
Barton County,Missouri,11625,11694,69,0.594
Hardeman County,Tennessee,25460,25529,69,0.271
Abbeville County,South Carolina,24287,24356,69,0.284
Cumberland County,Virginia,9677,9746,69,0.713
Trimble County,Kentucky,8470,8539,69,0.815
Brule County,South Dakota,5253,5321,68,1.294
Franklin city,Virginia,8179,8247,68,0.831
Langlade County,Wisconsin,19491,19559,68,0.349
Clark County,South Dakota,3844,3912,68,1.769
Franklin County,Kentucky,51539,51607,68,0.132
Highland County,Virginia,2233,2301,68,3.045
Clark County,Kentucky,36993,37061,68,0.184
Carter County,Missouri,5201,5268,67,1.288
Butler County,Nebraska,8360,8427,67,0.801
Mills County,Iowa,14486,14553,67,0.463
Kewaunee County,Wisconsin,20556,20623,67,0.326
Mineral County,Colorado,865,931,66,7.63
Ottawa County,Kansas,5729,5795,66,1.152
Geauga County,Ohio,95403,95469,66,0.069
Bon Homme County,South Dakota,6997,7062,65,0.929
Howard County,Iowa,9468,9533,65,0.687
Deuel County,Nebraska,1837,1902,65,3.538
Ralls County,Missouri,10355,10420,65,0.628
Tift County,Georgia,41347,41412,65,0.157
Merrick County,Nebraska,7659,7721,62,0.81
Yankton County,South Dakota,23311,23373,62,0.266
Duval County,Texas,9827,9888,61,0.621
Coos County,Oregon,64929,64990,61,0.094
Carter County,Tennessee,56349,56410,61,0.108
Grant County,Minnesota,6075,6136,61,1.004
Taylor County,Wisconsin,19915,19975,60,0.301
Jones County,North Carolina,9173,9233,60,0.654
Tioga County,Pennsylvania,41046,41106,60,0.146
Deuel County,South Dakota,4293,4352,59,1.374
Goshen County,Wyoming,12503,12562,59,0.472
Cumberland County,Kentucky,5887,5946,59,1.002
Garvin County,Oklahoma,25655,25713,58,0.226
Nevada County,California,102235,102293,58,0.057
Emmet County,Michigan,34105,34163,58,0.17
Calhoun County,South Carolina,14122,14179,57,0.404
Marshall County,South Dakota,4317,4374,57,1.32
Glascock County,Georgia,2882,2939,57,1.978
Allen County,Kansas,12522,12579,57,0.455
Schuylkill County,Pennsylvania,143048,143104,56,0.039
Greer County,Oklahoma,5492,5547,55,1.001
McLean County,North Dakota,9770,9824,54,0.553
Coke County,Texas,3280,3333,53,1.616
Van Buren County,Iowa,7203,7256,53,0.736
Lucas County,Iowa,8636,8689,53,0.614
Richland County,North Dakota,16528,16580,52,0.315
Jackson County,Kansas,13234,13286,52,0.393
Grand County,Colorado,15717,15769,52,0.331
Jefferson County,Oklahoma,5338,5389,51,0.955
Piatt County,Illinois,16672,16723,51,0.306
Butler County,Missouri,42128,42179,51,0.121
Bacon County,Georgia,11140,11191,51,0.458
Isabella County,Michigan,64396,64447,51,0.079
Piute County,Utah,1437,1487,50,3.479
Johnson County,Georgia,9192,9242,50,0.544
Marion County,Kansas,11819,11868,49,0.415
Ontonagon County,Michigan,5814,5863,49,0.843
Bracken County,Kentucky,8403,8452,49,0.583
Glasscock County,Texas,1115,1164,49,4.395
Sterling County,Texas,1369,1417,48,3.506
Berrien County,Georgia,18166,18214,48,0.264
Dent County,Missouri,14419,14467,48,0.333
Bennington County,Vermont,37344,37392,48,0.129
Garfield County,Montana,1170,1218,48,4.103
Washington County,Indiana,28176,28224,48,0.17
Ottawa County,Oklahoma,30291,30338,47,0.155
Hancock County,Mississippi,46047,46094,47,0.102
Franklin County,Florida,12452,12498,46,0.369
Mills County,Texas,4454,4500,46,1.033
Dawes County,Nebraska,8195,8241,46,0.561
Montgomery County,Georgia,8610,8655,45,0.523
Decatur County,Iowa,7639,7683,44,0.576
De Soto Parish,Louisiana,26809,26853,44,0.164
St. Francois County,Missouri,66926,66969,43,0.064
Cheyenne County,Nebraska,9468,9511,43,0.454
Coal County,Oklahoma,5270,5313,43,0.816
Howard County,Nebraska,6472,6515,43,0.664
Itawamba County,Mississippi,23861,23903,42,0.176
Perry County,Arkansas,10021,10063,42,0.419
Page County,Virginia,23708,23750,42,0.177
Platte County,Wyoming,8603,8645,42,0.488
Harrison County,Missouri,8158,8199,41,0.503
Greeley County,Nebraska,2186,2227,41,1.876
Clay County,Tennessee,7580,7620,40,0.528
Hughes County,Oklahoma,13367,13407,40,0.299
Patrick County,Virginia,17604,17643,39,0.222
Converse County,Wyoming,13747,13786,39,0.284
Taliaferro County,Georgia,1562,1600,38,2.433
Sweet Grass County,Montana,3677,3715,38,1.033
Rio Blanco County,Colorado,6531,6569,38,0.582
Sanilac County,Michigan,40619,40657,38,0.094
Robertson County,Kentucky,2192,2229,37,1.688
Concho County,Texas,3303,3340,37,1.12
Washakie County,Wyoming,7682,7719,37,0.482
Yakutat City and Borough,Alaska,664,700,36,5.422
Holt County,Missouri,4226,4262,36,0.852
Surry County,North Carolina,71367,71403,36,0.05
Covington County,Alabama,37567,37602,35,0.093
Sublette County,Wyoming,8728,8763,35,0.401
Lander County,Nevada,5732,5766,34,0.593
Jefferson County,Iowa,15665,15698,33,0.211
Richmond County,Georgia,206607,206640,33,0.016
Lake County,California,68158,68191,33,0.048
Dickinson County,Kansas,18397,18430,33,0.179
Washington County,Kentucky,12028,12061,33,0.274
Hodgeman County,Kansas,1723,1755,32,1.857
Wilkes County,Georgia,9567,9599,32,0.334
Chautauqua County,Kansas,3383,3415,32,0.946
Essex County,Virginia,10598,10630,32,0.302
Campbell County,Wyoming,47027,47058,31,0.066
Knox County,Missouri,3745,3776,31,0.828
Powder River County,Montana,1694,1725,31,1.83
Mason County,Texas,3951,3982,31,0.785
Clark County,Wisconsin,34660,34691,31,0.089
Lake County,Minnesota,10910,10939,29,0.266
Petroleum County,Montana,496,524,28,5.645
Burt County,Nebraska,6727,6755,28,0.416
Pulaski County,Arkansas,399117,399145,28,0.007
Day County,South Dakota,5451,5479,28,0.514
Monroe County,Indiana,139717,139745,28,0.02
Grundy County,Iowa,12329,12356,27,0.219
Daviess County,Indiana,33391,33418,27,0.081
Phillips County,Montana,4215,4240,25,0.593
Warren County,Indiana,8436,8461,25,0.296
Ripley County,Missouri,10678,10703,25,0.234
Grundy County,Missouri,9814,9838,24,0.245
Carroll County,Tennessee,28434,28458,24,0.084
Phelps County,Nebraska,8964,8988,24,0.268
Guthrie County,Iowa,10623,10647,24,0.226
Pendleton County,Kentucky,14652,14676,24,0.164
Washington County,Virginia,53934,53958,24,0.044
Sullivan County,Pennsylvania,5832,5855,23,0.394
Sully County,South Dakota,1448,1471,23,1.588
Val Verde County,Texas,47584,47606,22,0.046
Sheridan County,Montana,3542,3564,22,0.621
Bristol Bay Borough,Alaska,843,865,22,2.61
Sheridan County,North Dakota,1273,1295,22,1.728
Wayne County,Pennsylvania,51151,51173,22,0.043
Blaine County,Nebraska,432,453,21,4.861
Douglas County,Illinois,19734,19755,21,0.106
Sherman County,Nebraska,2959,2980,21,0.71
Gilliam County,Oregon,1997,2018,21,1.052
Harding County,South Dakota,1309,1330,21,1.604
Weston County,Wyoming,6840,6860,20,0.292
Davis County,Iowa,9110,9130,20,0.22
Howard County,Missouri,10148,10168,20,0.197
Owen County,Kentucky,11271,11290,19,0.169
Monroe County,Kentucky,11336,11355,19,0.168
Craig County,Oklahoma,14104,14123,19,0.135
Stanley County,South Dakota,2980,2999,19,0.638
Keya Paha County,Nebraska,768,787,19,2.474
Sherman County,Texas,2780,2799,19,0.683
Greene County,Mississippi,13533,13552,19,0.14
Clark County,Idaho,788,806,18,2.284
Valley County,Nebraska,4055,4073,18,0.444
Irion County,Texas,1513,1530,17,1.124
Pierce County,Nebraska,7315,7332,17,0.232
Hamilton County,New York,5102,5118,16,0.314
Harney County,Oregon,7499,7515,16,0.213
Osage County,Oklahoma,45823,45839,16,0.035
Beauregard Parish,Louisiana,36554,36570,16,0.044
Ionia County,Michigan,66793,66809,16,0.024
Jackson County,Kentucky,12958,12973,15,0.116
Esmeralda County,Nevada,729,744,15,2.058
Grafton County,New Hampshire,91112,91126,14,0.015
Prairie County,Montana,1093,1107,14,1.281
Independence County,Arkansas,37931,37945,14,0.037
Jackson County,South Dakota,2807,2821,14,0.499
Golden Valley County,North Dakota,1730,1744,14,0.809
Kearney County,Nebraska,6677,6690,13,0.195
Perry County,Indiana,19170,19183,13,0.068
Wheeler County,Nebraska,772,785,13,1.684
Davison County,South Dakota,19960,19973,13,0.065
Liberty County,Montana,1959,1972,13,0.664
Talbot County,Georgia,5735,5747,12,0.209
Jenkins County,Georgia,8678,8689,11,0.127
Quitman County,Georgia,2238,2249,11,0.492
Carbon County,Wyoming,14531,14542,11,0.076
Golden Valley County,Montana,824,835,11,1.335
Eureka County,Nevada,1853,1863,10,0.54
Crawford County,Georgia,12130,12140,10,0.082
Muskogee County,Oklahoma,66344,66354,10,0.015
Tillman County,Oklahoma,6967,6977,10,0.144
Candler County,Georgia,10990,11000,10,0.091
Ellis County,Kansas,28932,28941,9,0.031
Moody County,South Dakota,6340,6349,9,0.142
Daviess County,Missouri,8426,8435,9,0.107
Aurora County,South Dakota,2746,2755,9,0.328
Cherry County,Nebraska,5455,5464,9,0.165
Boone County,Nebraska,5377,5385,8,0.149
Grayson County,Virginia,15335,15343,8,0.052
Ringgold County,Iowa,4663,4670,7,0.15
LaMoure County,North Dakota,4091,4098,7,0.171
Tipton County,Indiana,15355,15361,6,0.039
Brown County,Ohio,43674,43680,6,0.014
Ashland County,Wisconsin,16033,16039,6,0.037
Crawford County,Indiana,10530,10536,6,0.057
Kenedy County,Texas,352,358,6,1.705
Pike County,Alabama,33008,33014,6,0.018
Galax city,Virginia,6725,6730,5,0.074
Armstrong County,Texas,1846,1850,4,0.217
Faribault County,Minnesota,13922,13926,4,0.029
Vermillion County,Indiana,15447,15451,4,0.026
Menard County,Texas,1964,1968,4,0.204
Washington County,Iowa,22567,22571,4,0.018
Henry County,Indiana,48912,48915,3,0.006
Thomas County,Nebraska,668,671,3,0.449
Hillsdale County,Michigan,45759,45762,3,0.007
Clinton County,Illinois,36906,36909,3,0.008
Champaign County,Ohio,38707,38709,2,0.005
Chouteau County,Montana,5896,5898,2,0.034
Platte County,Nebraska,34294,34296,2,0.006
Pope County,Illinois,3768,3770,2,0.053
Kalawao County,Hawaii,80,82,2,2.5
Maries County,Missouri,8430,8431,1,0.012
Antelope County,Nebraska,6292,6293,1,0.016
Baylor County,Texas,3465,3466,1,0.029
Arthur County,Nebraska,433,433,0,0
Shawano County,Wisconsin,40886,40886,0,0
Johnson County,Nebraska,5287,5287,0,0
Steele County,North Dakota,1788,1788,0,0
Faulk County,South Dakota,2126,2126,0,0
Gove County,Kansas,2717,2717,0,0
Benton County,Indiana,8720,8719,-1,-0.011
Treasure County,Montana,759,758,-1,-0.132
Hanson County,South Dakota,3462,3461,-1,-0.029
Pike County,Arkansas,10180,10179,-1,-0.01
Hamilton County,Nebraska,9431,9429,-2,-0.021
Washington County,Colorado,4814,4812,-2,-0.042
Newton County,Indiana,13825,13823,-2,-0.014
Steele County,Minnesota,37400,37398,-2,-0.005
Bottineau County,North Dakota,6378,6376,-2,-0.031
Kidder County,North Dakota,2395,2393,-2,-0.084
Clay County,Georgia,2847,2845,-2,-0.07
Franklin County,Kansas,25994,25992,-2,-0.008
Miner County,South Dakota,2307,2304,-3,-0.13
Kinney County,Texas,3131,3128,-3,-0.096
Dubois County,Indiana,43635,43632,-3,-0.007
Sauk County,Wisconsin,65780,65777,-3,-0.005
Briscoe County,Texas,1434,1431,-3,-0.209
Wilson County,Kansas,8625,8622,-3,-0.035
Martin County,Indiana,9806,9803,-3,-0.031
De Baca County,New Mexico,1697,1693,-4,-0.236
Adair County,Iowa,7498,7494,-4,-0.053
Fillmore County,Nebraska,5557,5553,-4,-0.072
Loup County,Nebraska,603,599,-4,-0.663
Wheeler County,Oregon,1449,1445,-4,-0.276
Edwards County,Texas,1427,1422,-5,-0.35
Colleton County,South Carolina,38604,38599,-5,-0.013
Comanche County,Kansas,1687,1681,-6,-0.356
Graham County,Kansas,2417,2411,-6,-0.248
Hand County,South Dakota,3146,3140,-6,-0.191
Rusk County,Wisconsin,14192,14186,-6,-0.042
Iron County,Michigan,11628,11622,-6,-0.052
Holmes County,Florida,19657,19651,-6,-0.031
Wilcox County,Georgia,8767,8761,-6,-0.068
Lyon County,Minnesota,25268,25262,-6,-0.024
Woodson County,Kansas,3115,3109,-6,-0.193
Grant County,West Virginia,10975,10968,-7,-0.064
Crittenden County,Kentucky,8988,8981,-7,-0.078
Cedar County,Nebraska,8378,8371,-7,-0.084
Carroll County,Virginia,29154,29147,-7,-0.024
Hayes County,Nebraska,856,849,-7,-0.818
Oldham County,Texas,1759,1752,-7,-0.398
Hall County,Texas,2817,2810,-7,-0.248
Sioux County,Nebraska,1135,1127,-8,-0.705
Hamilton County,Illinois,7993,7984,-9,-0.113
Hinsdale County,Colorado,784,775,-9,-1.148
Haskell County,Texas,5412,5403,-9,-0.166
Luce County,Michigan,5339,5330,-9,-0.169
Meade County,Kentucky,30011,30001,-10,-0.033
Monroe County,Missouri,8662,8652,-10,-0.115
Lawrence County,Arkansas,16216,16205,-11,-0.068
Osborne County,Kansas,3501,3490,-11,-0.314
Hyde County,North Carolina,4587,4576,-11,-0.24
Alpine County,California,1201,1190,-11,-0.916
Loving County,Texas,63,51,-12,-19.048
Appling County,Georgia,18440,18428,-12,-0.065
Worth County,Missouri,1967,1955,-12,-0.61
Jerauld County,South Dakota,1663,1650,-13,-0.782
Kent County,Texas,753,740,-13,-1.726
Shelby County,Texas,24022,24008,-14,-0.058
McPherson County,South Dakota,2409,2395,-14,-0.581
Garfield County,Nebraska,1815,1801,-14,-0.771
Putnam County,Missouri,4680,4666,-14,-0.299
Banner County,Nebraska,674,660,-14,-2.077
Carson County,Texas,5799,5784,-15,-0.259
Grant County,Oregon,7233,7218,-15,-0.207
Divide County,North Dakota,2202,2187,-15,-0.681
Jefferson County,Kansas,18359,18344,-15,-0.082
Mora County,New Mexico,4185,4169,-16,-0.382
Cheyenne County,Colorado,1748,1732,-16,-0.915
Humboldt County,Nevada,17288,17272,-16,-0.093
Rice County,Kansas,9423,9407,-16,-0.17
Plymouth County,Iowa,25697,25681,-16,-0.062
Echols County,Georgia,3703,3686,-17,-0.459
Pulaski County,Missouri,53958,53941,-17,-0.032
Franklin County,Nebraska,2890,2873,-17,-0.588
Pawnee County,Nebraska,2545,2528,-17,-0.668
Cochran County,Texas,2543,2526,-17,-0.669
Sierra County,California,3234,3217,-17,-0.526
Ziebach County,South Dakota,2413,2395,-18,-0.746
Lane County,Kansas,1574,1556,-18,-1.144
Foster County,North Dakota,3396,3378,-18,-0.53
Scotland County,North Carolina,34180,34162,-18,-0.053
Clayton County,Iowa,17045,17027,-18,-0.106
Hitchcock County,Nebraska,2616,2598,-18,-0.688
McCone County,Montana,1728,1709,-19,-1.1
Rock County,Nebraska,1264,1245,-19,-1.503
Lincoln County,Arkansas,12936,12916,-20,-0.155
Oliver County,North Dakota,1876,1856,-20,-1.066
Wibaux County,Montana,939,919,-20,-2.13
Stephens County,Georgia,26787,26767,-20,-0.075
Union County,Oregon,26197,26177,-20,-0.076
Willacy County,Texas,20163,20143,-20,-0.099
Nelson County,North Dakota,3015,2995,-20,-0.663
Crockett County,Tennessee,13909,13888,-21,-0.151
Mercer County,North Dakota,8354,8333,-21,-0.251
Webster County,Georgia,2349,2328,-21,-0.894
Vermilion Parish,Louisiana,56973,56952,-21,-0.037
Aleutians East Borough,Alaska,3419,3398,-21,-0.614
Kiowa County,Colorado,1445,1424,-21,-1.453
Harlan County,Nebraska,3076,3054,-22,-0.715
Roanoke County,Virginia,96936,96914,-22,-0.023
Martin County,Texas,5239,5217,-22,-0.42
Sheridan County,Kansas,2448,2425,-23,-0.94
Lincoln County,Nevada,4505,4482,-23,-0.511
Nicollet County,Minnesota,34464,34441,-23,-0.067
Chariton County,Missouri,7409,7386,-23,-0.31
Big Stone County,Minnesota,5168,5144,-24,-0.464
Eddy County,North Dakota,2338,2314,-24,-1.027
Monroe County,Iowa,7574,7550,-24,-0.317
Rush County,Kansas,2951,2927,-24,-0.813
McMullen County,Texas,600,576,-24,-4
Haines Borough,Alaska,2080,2056,-24,-1.154
Gibson County,Indiana,33017,32993,-24,-0.073
Pocahontas County,Iowa,7077,7053,-24,-0.339
Hooker County,Nebraska,711,686,-25,-3.516
Seminole County,Georgia,9152,9127,-25,-0.273
Logan County,North Dakota,1880,1855,-25,-1.33
Roberts County,Texas,828,803,-25,-3.019
Greene County,Iowa,8766,8741,-25,-0.285
Campbell County,South Dakota,1375,1349,-26,-1.891
Gasconade County,Missouri,14794,14768,-26,-0.176
Fulton County,Pennsylvania,14559,14533,-26,-0.179
Humboldt County,Iowa,9598,9572,-26,-0.271
Casey County,Kentucky,15946,15920,-26,-0.163
Slope County,North Dakota,699,672,-27,-3.863
Smith County,Kansas,3560,3533,-27,-0.758
Harding County,New Mexico,655,628,-27,-4.122
Ellsworth County,Kansas,6383,6355,-28,-0.439
Mellette County,South Dakota,1920,1892,-28,-1.458
Scott County,Arkansas,9833,9805,-28,-0.285
Morrill County,Nebraska,4555,4527,-28,-0.615
Chase County,Kansas,2576,2548,-28,-1.087
McPherson County,Nebraska,400,372,-28,-7
Wayne County,Iowa,6495,6467,-28,-0.431
Cass County,Iowa,13132,13104,-28,-0.213
Noble County,Oklahoma,10925,10896,-29,-0.265
King County,Texas,262,233,-29,-11.069
Copper River Census Area,Alaska,2618,2589,-29,-1.108
Daniels County,Montana,1657,1628,-29,-1.75
Gregory County,South Dakota,3991,3962,-29,-0.727
Wallace County,Kansas,1517,1488,-29,-1.912
Brown County,Nebraska,2902,2872,-30,-1.034
Alger County,Michigan,8837,8807,-30,-0.339
Lyman County,South Dakota,3722,3692,-30,-0.806
Hot Springs County,Wyoming,4618,4588,-30,-0.65
Mineral County,Nevada,4555,4525,-30,-0.659
Motley County,Texas,1063,1032,-31,-2.916
Coshocton County,Ohio,36602,36571,-31,-0.085
Mitchell County,Iowa,10563,10532,-31,-0.293
Washington County,Kansas,5532,5501,-31,-0.56
Ness County,Kansas,2676,2645,-31,-1.158
Roseau County,Minnesota,15323,15292,-31,-0.202
Surry County,Virginia,6558,6527,-31,-0.473
Perkins County,Nebraska,2861,2829,-32,-1.118
Schuyler County,Missouri,4034,4002,-32,-0.793
Rawlins County,Kansas,2560,2528,-32,-1.25
Kay County,Oklahoma,43701,43668,-33,-0.076
Culberson County,Texas,2188,2155,-33,-1.508
Hardeman County,Texas,3549,3516,-33,-0.93
Carter County,Montana,1415,1382,-33,-2.332
Lafayette County,Missouri,32994,32961,-33,-0.1
Chattooga County,Georgia,24969,24936,-33,-0.132
Lac qui Parle County,Minnesota,6722,6689,-33,-0.491
Cheyenne County,Kansas,2616,2583,-33,-1.261
Jones County,South Dakota,919,884,-35,-3.808
Woods County,Oklahoma,8622,8587,-35,-0.406
Foard County,Texas,1092,1057,-35,-3.205
Garden County,Nebraska,1872,1837,-35,-1.87
Beaver County,Oklahoma,5052,5016,-36,-0.713
Treutlen County,Georgia,6401,6365,-36,-0.562
Stevens County,Minnesota,9673,9637,-36,-0.372
Teton County,Wyoming,23323,23287,-36,-0.154
Grant County,Nebraska,613,576,-37,-6.036
Titus County,Texas,31245,31208,-37,-0.118
Pulaski County,Indiana,12523,12485,-38,-0.303
Wayne County,North Carolina,117324,117286,-38,-0.032
Taylor County,Iowa,5896,5858,-38,-0.645
Perkins County,South Dakota,2842,2804,-38,-1.337
Fallon County,Montana,3049,3011,-38,-1.246
Grant County,Oklahoma,4162,4124,-38,-0.913
Elk County,Kansas,2479,2441,-38,-1.533
Clay County,Alabama,14237,14198,-39,-0.274
Petersburg Borough,Alaska,3399,3360,-39,-1.147
Clear Creek County,Colorado,9394,9355,-39,-0.415
Zapata County,Texas,13888,13849,-39,-0.281
Franklin County,Mississippi,7681,7642,-39,-0.508
Denali Borough,Alaska,1624,1585,-39,-2.401
Runnels County,Texas,9899,9859,-40,-0.404
Jewell County,Kansas,2938,2898,-40,-1.361
Morris County,Kansas,5389,5349,-40,-0.742
Republic County,Kansas,4682,4642,-40,-0.854
Thomas County,Kansas,7933,7893,-40,-0.504
Southeastern Connecticut Planning Region,Connecticut,280444,280403,-41,-0.015
Nemaha County,Nebraska,7076,7035,-41,-0.579
Lincoln County,Kansas,2940,2899,-41,-1.395
Pierce County,North Dakota,3983,3942,-41,-1.029
Cimarron County,Oklahoma,2293,2252,-41,-1.788
Potter County,South Dakota,2480,2438,-42,-1.694
Preston County,West Virginia,34214,34172,-42,-0.123
Traill County,North Dakota,8000,7958,-42,-0.525
Maverick County,Texas,57885,57843,-42,-0.073
Bennett County,South Dakota,3378,3336,-42,-1.243
Dickens County,Texas,1769,1726,-43,-2.431
Miller County,Arkansas,42595,42552,-43,-0.101
Borden County,Texas,628,585,-43,-6.847
Logan County,Nebraska,718,675,-43,-5.989
Polk County,Nebraska,5209,5166,-43,-0.825
Russell County,Kansas,6684,6639,-45,-0.673
Powell County,Kentucky,13128,13083,-45,-0.343
McLeod County,Minnesota,36759,36714,-45,-0.122
Wheatland County,Montana,2077,2032,-45,-2.167
Mathews County,Virginia,8535,8490,-45,-0.527
Lincoln County,Wisconsin,28421,28376,-45,-0.158
Portage County,Ohio,161790,161745,-45,-0.028
Walworth County,South Dakota,5310,5265,-45,-0.847
Cotton County,Oklahoma,5523,5477,-46,-0.833
Paulding County,Ohio,18803,18757,-46,-0.245
Brooks County,Georgia,16299,16253,-46,-0.282
Red River County,Texas,11588,11542,-46,-0.397
Calhoun County,Arkansas,4742,4695,-47,-0.991
McLean County,Kentucky,9152,9105,-47,-0.514
Yellow Medicine County,Minnesota,9533,9486,-47,-0.493
Pushmataha County,Oklahoma,10816,10769,-47,-0.435
Barbour County,West Virginia,15462,15414,-48,-0.31
Mitchell County,Texas,8991,8943,-48,-0.534
Craig County,Virginia,4895,4847,-48,-0.981
Graham County,North Carolina,8029,7980,-49,-0.61
Marathon County,Wisconsin,138007,137958,-49,-0.036
La Paz County,Arizona,16555,16506,-49,-0.296
Houston County,Minnesota,18849,18800,-49,-0.26
Fisher County,Texas,3671,3622,-49,-1.335
Linn County,Missouri,11870,11820,-50,-0.421
Hardin County,Illinois,3647,3597,-50,-1.371
DeWitt County,Texas,19822,19772,-50,-0.252
Haakon County,South Dakota,1876,1826,-50,-2.665
Buena Vista city,Virginia,6641,6591,-50,-0.753
Schley County,Georgia,4546,4496,-50,-1.1
Nance County,Nebraska,3377,3326,-51,-1.51
Clarke County,Iowa,9744,9692,-52,-0.534
Douglas County,South Dakota,2828,2776,-52,-1.839
Ray County,Missouri,23160,23107,-53,-0.229
Forrest County,Mississippi,78163,78110,-53,-0.068
Menominee County,Wisconsin,4250,4197,-53,-1.247
Mitchell County,Kansas,5792,5738,-54,-0.932
McIntosh County,North Dakota,2529,2475,-54,-2.135
Bollinger County,Missouri,10572,10518,-54,-0.511
Adams County,Ohio,27474,27420,-54,-0.197
Kiowa County,Kansas,2458,2404,-54,-2.197
Pocahontas County,West Virginia,7873,7819,-54,-0.686
Griggs County,North Dakota,2306,2252,-54,-2.342
Montour County,Pennsylvania,18145,18091,-54,-0.298
Carroll County,Ohio,26714,26659,-55,-0.206
Trego County,Kansas,2807,2752,-55,-1.959
Fayette County,Indiana,23404,23349,-55,-0.235
Clark County,Kansas,1988,1933,-55,-2.767
Decatur County,Indiana,26471,26416,-55,-0.208
Hutchinson County,South Dakota,7423,7368,-55,-0.741
Nuckolls County,Nebraska,4096,4041,-55,-1.343
Warren County,Georgia,5211,5155,-56,-1.075
Tripp County,South Dakota,5621,5565,-56,-0.996
Marshall County,Kansas,10038,9982,-56,-0.558
Clay County,Nebraska,6105,6049,-56,-0.917
Wells County,North Dakota,3986,3930,-56,-1.405
Burke County,North Dakota,2211,2155,-56,-2.533
Wrangell City and Borough,Alaska,2126,2070,-56,-2.634
Emmons County,North Dakota,3306,3250,-56,-1.694
Marion County,Georgia,7506,7449,-57,-0.759
Logan County,Kansas,2762,2705,-57,-2.064
Rockbridge County,Virginia,22650,22593,-57,-0.252
Doniphan County,Kansas,7498,7440,-58,-0.774
Redwood County,Minnesota,15419,15361,-58,-0.376
Gogebic County,Michigan,14377,14319,-58,-0.403
Charlotte County,Virginia,11533,11475,-58,-0.503
Clinton County,Ohio,42022,41964,-58,-0.138
Furnas County,Nebraska,4633,4575,-58,-1.252
Ransom County,North Dakota,5699,5640,-59,-1.035
Elliott County,Kentucky,7352,7293,-59,-0.803
Vernon County,Missouri,19710,19651,-59,-0.299
Greeley County,Kansas,1282,1223,-59,-4.602
Grant County,North Dakota,2302,2243,-59,-2.563
Wyoming County,Pennsylvania,26073,26014,-59,-0.226
Webster County,Nebraska,3396,3336,-60,-1.767
Stark County,Illinois,5405,5345,-60,-1.11
Harmon County,Oklahoma,2488,2428,-60,-2.412
Shelby County,Indiana,45052,44991,-61,-0.135
Pipestone County,Minnesota,9416,9355,-61,-0.648
Keith County,Nebraska,8331,8269,-62,-0.744
Houston County,Tennessee,8281,8219,-62,-0.749
Issaquena County,Mississippi,1335,1273,-62,-4.644
Renville County,North Dakota,2282,2220,-62,-2.717
Alpena County,Michigan,28909,28847,-62,-0.214
Red Lake County,Minnesota,3936,3874,-62,-1.575
La Salle County,Texas,6667,6604,-63,-0.945
Alfalfa County,Oklahoma,5700,5637,-63,-1.105
Petersburg city,Virginia,33457,33394,-63,-0.188
Anderson County,Kansas,7839,7776,-63,-0.804
Stonewall County,Texas,1246,1182,-64,-5.136
Lincoln County,Minnesota,5644,5580,-64,-1.134
Valley County,Montana,7577,7513,-64,-0.845
San Augustine County,Texas,7921,7857,-64,-0.808
Randolph County,Indiana,24502,24437,-65,-0.265
Sargent County,North Dakota,3860,3795,-65,-1.684
Hancock County,Ohio,74926,74861,-65,-0.087
Norman County,Minnesota,6442,6377,-65,-1.009
St. Joseph County,Michigan,60939,60874,-65,-0.107
Covington city,Virginia,5744,5679,-65,-1.132
Putnam County,Illinois,5638,5572,-66,-1.171
Butler County,Iowa,14335,14269,-66,-0.46
Scotland County,Missouri,4709,4643,-66,-1.402
Sitka City and Borough,Alaska,8448,8382,-66,-0.781
Marshall County,Illinois,11744,11678,-66,-0.562
Winnebago County,Iowa,10683,10617,-66,-0.618
Terrell County,Texas,760,693,-67,-8.816
Jim Wells County,Texas,38893,38826,-67,-0.172
Dundy County,Nebraska,1657,1590,-67,-4.043
Custer County,Nebraska,10543,10476,-67,-0.635
Windham County,Vermont,45909,45842,-67,-0.146
Greenwood County,Kansas,6006,5939,-67,-1.116
Pleasants County,West Virginia,7653,7586,-67,-0.875
LaSalle Parish,Louisiana,14797,14729,-68,-0.46
Jackson County,Ohio,32654,32586,-68,-0.208
San Miguel County,Colorado,8071,8003,-68,-0.843
Clay County,Kansas,8112,8043,-69,-0.851
Pembina County,North Dakota,6832,6763,-69,-1.01
Knox County,Nebraska,8405,8336,-69,-0.821
Southampton County,Virginia,18001,17932,-69,-0.383
Page County,Iowa,15213,15143,-70,-0.46
Hopewell city,Virginia,23032,22962,-70,-0.304
Falls Church city,Virginia,14658,14586,-72,-0.491
Somerset County,Maryland,24618,24546,-72,-0.292
Jim Hogg County,Texas,4835,4763,-72,-1.489
Mahnomen County,Minnesota,5400,5328,-72,-1.333
Washington County,Missouri,23514,23441,-73,-0.31
Boyd County,Nebraska,1814,1741,-73,-4.024
Waseca County,Minnesota,18966,18893,-73,-0.385
Cottle County,Texas,1380,1307,-73,-5.29
Shiawassee County,Michigan,68095,68022,-73,-0.107
Carroll County,Missouri,8497,8423,-74,-0.871
Calhoun County,Illinois,4435,4360,-75,-1.691
Corson County,South Dakota,3901,3826,-75,-1.923
Jackson County,West Virginia,27792,27716,-76,-0.273
Jasper County,Illinois,9288,9212,-76,-0.818
Hyde County,South Dakota,1260,1184,-76,-6.032
Hancock County,Kentucky,9097,9021,-76,-0.835
Butler County,Kentucky,12371,12295,-76,-0.614
Hettinger County,North Dakota,2483,2406,-77,-3.101
Jackson County,Colorado,1379,1302,-77,-5.584
Evans County,Georgia,10772,10695,-77,-0.715
Hoonah-Angoon Census Area,Alaska,2364,2287,-77,-3.257
Stafford County,Kansas,4070,3993,-77,-1.892
Stevens County,Kansas,5252,5175,-77,-1.466
Caldwell County,Kentucky,12648,12570,-78,-0.617
Jennings County,Indiana,27614,27536,-78,-0.282
Dickinson County,Michigan,25952,25874,-78,-0.301
Clay County,Indiana,26457,26379,-78,-0.295
Coffey County,Kansas,8358,8280,-78,-0.933
Castro County,Texas,7376,7298,-78,-1.057
Baca County,Colorado,3510,3432,-78,-2.222
Audubon County,Iowa,5676,5598,-78,-1.374
Monroe County,West Virginia,12375,12296,-79,-0.638
Taylor County,Georgia,7816,7737,-79,-1.011
Dickey County,North Dakota,5002,4923,-79,-1.579
Collingsworth County,Texas,2648,2568,-80,-3.021
Ballard County,Kentucky,7730,7650,-80,-1.035
Knox County,Texas,3353,3273,-80,-2.386
Swift County,Minnesota,9835,9755,-80,-0.813
Dewey County,Oklahoma,4481,4401,-80,-1.785
Pawnee County,Kansas,6259,6179,-80,-1.278
Decatur County,Kansas,2770,2689,-81,-2.924
Cleveland County,Arkansas,7548,7467,-81,-1.073
Dunn County,North Dakota,4096,4015,-81,-1.978
Cuming County,Nebraska,9010,8929,-81,-0.899
Rush County,Indiana,16755,16673,-82,-0.489
Hughes County,South Dakota,17774,17692,-82,-0.461
Greenwood County,South Carolina,69349,69267,-82,-0.118
Mineral County,West Virginia,26938,26855,-83,-0.308
Snyder County,Pennsylvania,39735,39652,-83,-0.209
Nottoway County,Virginia,15642,15559,-83,-0.531
Garland County,Arkansas,100172,100089,-83,-0.083
Pike County,Ohio,27089,27005,-84,-0.31
Pike County,Indiana,12252,12168,-84,-0.686
Clinch County,Georgia,6746,6662,-84,-1.245
Buffalo County,South Dakota,1945,1861,-84,-4.319
Howard County,Indiana,83659,83574,-85,-0.102
Adams County,North Dakota,2200,2115,-85,-3.864
Lake County,South Dakota,11057,10972,-85,-0.769
Gosper County,Nebraska,1894,1808,-86,-4.541
Jefferson County,New York,116723,116637,-86,-0.074
Norton city,Virginia,3696,3609,-87,-2.354
Baker County,Georgia,2875,2788,-87,-3.026
Winneshiek County,Iowa,20061,19974,-87,-0.434
Reynolds County,Missouri,6093,6006,-87,-1.428
Defiance County,Ohio,38274,38187,-87,-0.227
Cloud County,Kansas,9034,8946,-88,-0.974
Jefferson County,Nebraska,7242,7154,-88,-1.215
Caldwell Parish,Louisiana,9642,9554,-88,-0.913
Phillips County,Colorado,4537,4449,-88,-1.94
Hamilton County,Kansas,2518,2430,-88,-3.495
Screven County,Georgia,14066,13977,-89,-0.633
Marion County,Missouri,28527,28438,-89,-0.312
Wichita County,Kansas,2153,2064,-89,-4.134
Ramsey County,North Dakota,11604,11515,-89,-0.767
Niobrara County,Wyoming,2469,2380,-89,-3.605
Barnes County,North Dakota,10848,10758,-90,-0.83
Glacier County,Montana,13771,13681,-90,-0.654
Ellis County,Oklahoma,3747,3657,-90,-2.402
Swisher County,Texas,6971,6881,-90,-1.291
Traverse County,Minnesota,3366,3275,-91,-2.704
Yuma County,Colorado,9990,9899,-91,-0.911
Randolph County,Missouri,24713,24622,-91,-0.368
Pratt County,Kansas,9159,9067,-92,-1.004
Scott County,Virginia,21568,21476,-92,-0.427
Gilmer County,West Virginia,7417,7325,-92,-1.24
Gates County,North Carolina,10475,10383,-92,-0.878
Grant County,South Dakota,7556,7463,-93,-1.231
Wayne County,Mississippi,19774,19681,-93,-0.47
White County,Indiana,24691,24598,-93,-0.377
Gallatin County,Illinois,4948,4855,-93,-1.88
Kusilvak Census Area,Alaska,8372,8278,-94,-1.123
Cowley County,Kansas,34547,34453,-94,-0.272
Holt County,Nebraska,10137,10043,-94,-0.927
Benton County,Mississippi,7644,7550,-94,-1.23
Pulaski County,Virginia,33800,33706,-94,-0.278
Noble County,Indiana,47461,47367,-94,-0.198
Cherokee County,South Carolina,56216,56121,-95,-0.169
Lake and Peninsula Borough,Alaska,1476,1381,-95,-6.436
Perry County,Missouri,18954,18858,-96,-0.506
Randolph County,Illinois,30165,30068,-97,-0.322
Jeff Davis County,Texas,2000,1903,-97,-4.85
Schleicher County,Texas,2454,2357,-97,-3.953
Adams County,Iowa,3708,3611,-97,-2.616
Cedar County,Iowa,18497,18399,-98,-0.53
Morton County,Kansas,2697,2599,-98,-3.634
Daviess County,Kentucky,103320,103222,-98,-0.095
Sherman County,Kansas,5928,5830,-98,-1.653
Towner County,North Dakota,2163,2064,-99,-4.577
Jackson County,Minnesota,9992,9893,-99,-0.991
Carlisle County,Kentucky,4819,4720,-99,-2.054
Todd County,South Dakota,9319,9220,-99,-1.062
Mercer County,Missouri,3537,3437,-100,-2.827
Franklin County,Iowa,10016,9916,-100,-0.998
Allamakee County,Iowa,14061,13960,-101,-0.718
Escambia County,Alabama,36767,36666,-101,-0.275
Lake County,Colorado,7428,7327,-101,-1.36
Hickman County,Kentucky,4523,4422,-101,-2.233
Dewey County,South Dakota,5242,5140,-102,-1.946
Wasco County,Oregon,26663,26561,-102,-0.383
Amite County,Mississippi,12721,12619,-102,-0.802
Bradford County,Pennsylvania,59969,59866,-103,-0.172
Prince of Wales-Hyder Census Area,Alaska,5753,5650,-103,-1.79
Union County,New Mexico,4083,3980,-103,-2.523
St. Helena Parish,Louisiana,10925,10822,-103,-0.943
Shelby County,Iowa,11748,11645,-103,-0.877
Bowman County,North Dakota,2997,2894,-103,-3.437
Logan County,Ohio,46144,46040,-104,-0.225
Harrison County,Ohio,14482,14378,-104,-0.718
Wirt County,West Virginia,5196,5091,-105,-2.021
Upshur County,West Virginia,23817,23712,-105,-0.441
Atkinson County,Georgia,8289,8183,-106,-1.279
Hardy County,West Virginia,14298,14192,-106,-0.741
Boone County,Iowa,26715,26609,-106,-0.397
Blaine County,Montana,7042,6936,-106,-1.505
Sedgwick County,Colorado,2402,2295,-107,-4.455
Calhoun County,Georgia,5576,5469,-107,-1.919
Refugio County,Texas,6739,6632,-107,-1.588
Rooks County,Kansas,4921,4813,-108,-2.195
Fayette County,Ohio,28947,28839,-108,-0.373
Crawford County,Wisconsin,16115,16007,-108,-0.67
Roberts County,South Dakota,10271,10163,-108,-1.052
Mariposa County,California,17128,17020,-108,-0.631
Hancock County,Iowa,10794,10685,-109,-1.01
Cavalier County,North Dakota,3706,3597,-109,-2.941
Doddridge County,West Virginia,7808,7698,-110,-1.409
Aleutians West Census Area,Alaska,5232,5122,-110,-2.102
Barber County,Kansas,4233,4122,-111,-2.622
Starke County,Indiana,23370,23258,-112,-0.479
Dawson County,Montana,8943,8830,-113,-1.264
Moffat County,Colorado,13291,13177,-114,-0.858
Ida County,Iowa,7002,6888,-114,-1.628
Putnam County,Ohio,34448,34334,-114,-0.331
Murray County,Minnesota,8175,8060,-115,-1.407
Osage County,Kansas,15770,15654,-116,-0.736
Houston County,Texas,22067,21950,-117,-0.53
Smith County,Mississippi,14209,14092,-117,-0.823
Bledsoe County,Tennessee,14916,14798,-118,-0.791
Nelson County,Virginia,14770,14652,-118,-0.799
Roger Mills County,Oklahoma,3439,3320,-119,-3.46
Stutsman County,North Dakota,21607,21487,-120,-0.555
Walsh County,North Dakota,10558,10438,-120,-1.137
Walthall County,Mississippi,13882,13761,-121,-0.872
Estill County,Kentucky,14166,14044,-122,-0.861
Chase County,Nebraska,3894,3772,-122,-3.133
Shelby County,Missouri,6104,5982,-122,-1.999
Stanton County,Kansas,2085,1963,-122,-5.851
Gage County,Nebraska,21706,21583,-123,-0.567
Yalobusha County,Mississippi,12487,12364,-123,-0.985
Kimball County,Nebraska,3438,3315,-123,-3.578
Telfair County,Georgia,12477,12354,-123,-0.986
Iron County,Missouri,9537,9414,-123,-1.29
Owsley County,Kentucky,4052,3929,-123,-3.036
Atchison County,Missouri,5306,5182,-124,-2.337
Matagorda County,Texas,36249,36125,-124,-0.342
Montgomery County,Iowa,10329,10205,-124,-1.201
Caswell County,North Carolina,22738,22614,-124,-0.545
Washington County,Illinois,13767,13643,-124,-0.901
Cumberland County,Illinois,10448,10324,-124,-1.187
Jackson County,Indiana,46425,46300,-125,-0.269
Worth County,Iowa,7444,7319,-125,-1.679
Bailey County,Texas,6904,6779,-125,-1.811
Andrew County,Missouri,18128,18003,-125,-0.69
Lewis County,Kentucky,13079,12954,-125,-0.956
Kit Carson County,Colorado,7086,6961,-125,-1.764
Bland County,Virginia,6274,6148,-126,-2.008
Ben Hill County,Georgia,17195,17069,-126,-0.733
Kearny County,Kansas,3981,3855,-126,-3.165
Clinton County,Iowa,46470,46344,-126,-0.271
Stanton County,Nebraska,5843,5717,-126,-2.156
O'Brien County,Iowa,14187,14060,-127,-0.895
Crosby County,Texas,5125,4998,-127,-2.478
Spink County,South Dakota,6362,6235,-127,-1.996
Dodge County,Georgia,19929,19802,-127,-0.637
Tyler County,West Virginia,8311,8183,-128,-1.54
Cameron County,Pennsylvania,4546,4418,-128,-2.816
Dillingham Census Area,Alaska,4853,4723,-130,-2.679
Hansford County,Texas,5281,5151,-130,-2.462
Clinton County,Kentucky,9253,9123,-130,-1.405
Crane County,Texas,4676,4546,-130,-2.78
Yell County,Arkansas,20259,20129,-130,-0.642
Keokuk County,Iowa,10035,9904,-131,-1.305
Manassas city,Virginia,42773,42642,-131,-0.306
Red Willow County,Nebraska,10705,10573,-132,-1.233
Fulton County,Kentucky,6515,6382,-133,-2.041
Lee County,Kentucky,7394,7261,-133,-1.799
Morgan County,Ohio,13802,13668,-134,-0.971
Nevada County,Arkansas,8315,8181,-134,-1.612
Pendleton County,West Virginia,6145,6011,-134,-2.181
Dixon County,Nebraska,5598,5464,-134,-2.394
Union County,Indiana,7087,6952,-135,-1.905
Crawford County,Illinois,18672,18536,-136,-0.728
Jackson County,Arkansas,16760,16624,-136,-0.811
Scott County,Kansas,5151,5014,-137,-2.66
McCulloch County,Texas,7634,7497,-137,-1.795
Leake County,Mississippi,21272,21135,-137,-0.644
Harper County,Oklahoma,3266,3129,-137,-4.195
Colfax County,Nebraska,10581,10444,-137,-1.295
Fremont County,Iowa,6602,6464,-138,-2.09
Warren County,New York,65737,65599,-138,-0.21
Sierra County,New Mexico,11574,11436,-138,-1.192
Sheridan County,Nebraska,5134,4996,-138,-2.688
Colfax County,New Mexico,12385,12246,-139,-1.122
Colquitt County,Georgia,45902,45762,-140,-0.305
Prowers County,Colorado,11995,11854,-141,-1.175
Guadalupe County,New Mexico,4451,4310,-141,-3.168
Franklin County,Massachusetts,71035,70894,-141,-0.198
Boyd County,Kentucky,48253,48110,-143,-0.296
McHenry County,North Dakota,5332,5189,-143,-2.682
Sac County,Iowa,9817,9673,-144,-1.467
Livingston County,Missouri,14546,14402,-144,-0.99
Lewis County,Missouri,10036,9891,-145,-1.445
Perry County,Mississippi,11514,11368,-146,-1.268
Newton County,Arkansas,7225,7078,-147,-2.035
Douglas County,Wisconsin,44291,44144,-147,-0.332
Brown County,Kansas,9511,9364,-147,-1.546
Thayer County,Nebraska,5032,4885,-147,-2.921
Swain County,North Carolina,14115,13967,-148,-1.049
Monroe County,Ohio,13383,13234,-149,-1.113
Posey County,Indiana,25213,25063,-150,-0.595
Sullivan County,Indiana,20820,20670,-150,-0.72
Adair County,Missouri,25315,25165,-150,-0.593
Oglala Lakota County,South Dakota,13669,13519,-150,-1.097
Cottonwood County,Minnesota,11506,11356,-150,-1.304
Henry County,Ohio,27662,27512,-150,-0.542
Sussex County,Virginia,10831,10680,-151,-1.394
San Juan County,Utah,14510,14359,-151,-1.041
Jackson County,North Carolina,43107,42955,-152,-0.353
Vigo County,Indiana,106158,106006,-152,-0.143
Fulton County,Indiana,20480,20327,-153,-0.747
Crockett County,Texas,3097,2943,-154,-4.973
Pennington County,Minnesota,13999,13845,-154,-1.1
Sutton County,Texas,3372,3217,-155,-4.597
Bedford County,Pennsylvania,47573,47418,-155,-0.326
Delta County,Michigan,36896,36741,-155,-0.42
Schuyler County,Illinois,6902,6746,-156,-2.26
Upton County,Texas,3308,3152,-156,-4.716
Grant County,Kansas,7353,7197,-156,-2.122
Bath County,Virginia,4205,4049,-156,-3.71
Bourbon County,Kentucky,20250,20093,-157,-0.775
Norton County,Kansas,5458,5301,-157,-2.877
Juniata County,Pennsylvania,23496,23339,-157,-0.668
Scott County,Illinois,4947,4790,-157,-3.174
Mifflin County,Pennsylvania,46145,45988,-157,-0.34
Charles Mix County,South Dakota,9370,9213,-157,-1.676
Kittson County,Minnesota,4217,4059,-158,-3.747
Meade County,Kansas,4055,3897,-158,-3.896
Wabash County,Indiana,30986,30828,-158,-0.51
Kiowa County,Oklahoma,8503,8345,-158,-1.858
Sevier County,Arkansas,15844,15686,-158,-0.997
Sabine Parish,Louisiana,22144,21985,-159,-0.718
Gallia County,Ohio,29227,29068,-159,-0.544
Sullivan County,Missouri,5999,5840,-159,-2.65
Turner County,Georgia,9001,8842,-159,-1.766
Osceola County,Iowa,6196,6036,-160,-2.582
Bullock County,Alabama,10362,10202,-160,-1.544
Louisa County,Iowa,10837,10677,-160,-1.476
Huron County,Michigan,31408,31248,-160,-0.509
Yukon-Koyukuk Census Area,Alaska,5339,5179,-160,-2.997
Baldwin County,Georgia,43795,43635,-160,-0.365
Calhoun County,West Virginia,6228,6068,-160,-2.569
Pittsburg County,Oklahoma,43774,43613,-161,-0.368
Harper County,Kansas,5484,5323,-161,-2.936
Wolfe County,Kentucky,6561,6400,-161,-2.454
Jackson County,Iowa,19485,19324,-161,-0.826
Wayne County,New York,91286,91125,-161,-0.176
Skagway Municipality,Alaska,1242,1081,-161,-12.963
Monroe County,Wisconsin,46270,46109,-161,-0.348
Floyd County,Texas,5397,5235,-162,-3.002
Nemaha County,Kansas,10277,10115,-162,-1.576
Edwards County,Kansas,2901,2739,-162,-5.584
Bond County,Illinois,16729,16566,-163,-0.974
Greensville County,Virginia,11389,11226,-163,-1.431
Macon County,Missouri,15212,15049,-163,-1.072
Grant Parish,Louisiana,22163,22000,-163,-0.735
Wilkin County,Minnesota,6513,6350,-163,-2.503
Elkhart County,Indiana,207054,206890,-164,-0.079
Rock County,Minnesota,9701,9537,-164,-1.691
Newton County,Texas,12216,12052,-164,-1.343
Charles City County,Virginia,6770,6605,-165,-2.437
Wheeler County,Georgia,7479,7314,-165,-2.206
Dade County,Georgia,16246,16081,-165,-1.016
Richardson County,Nebraska,7870,7705,-165,-2.097
Winston County,Mississippi,17709,17543,-166,-0.937
Hemphill County,Texas,3383,3217,-166,-4.907
Lincoln County,Colorado,5677,5510,-167,-2.942
Hartley County,Texas,5376,5208,-168,-3.125
Marion County,Texas,9728,9560,-168,-1.727
Van Wert County,Ohio,28937,28769,-168,-0.581
Box Butte County,Nebraska,10841,10672,-169,-1.559
Lancaster County,Virginia,10919,10750,-169,-1.548
Bladen County,North Carolina,29617,29446,-171,-0.577
Marshall County,Minnesota,9032,8861,-171,-1.893
Barnwell County,South Carolina,20585,20414,-171,-0.831
Caldwell County,North Carolina,80664,80492,-172,-0.213
Crenshaw County,Alabama,13197,13025,-172,-1.303
Jefferson County,Mississippi,7260,7087,-173,-2.383
Washington County,North Carolina,11001,10828,-173,-1.573
Cherokee County,Iowa,11664,11491,-173,-1.483
Wythe County,Virginia,28285,28111,-174,-0.615
Dodge County,Nebraska,37171,36997,-174,-0.468
Richmond County,North Carolina,42953,42778,-175,-0.407
Menard County,Illinois,12296,12121,-175,-1.423
Saline County,Nebraska,14291,14116,-175,-1.225
Watonwan County,Minnesota,11251,11075,-176,-1.564
Edwards County,Illinois,6247,6071,-176,-2.817
Carroll County,Illinois,15705,15529,-176,-1.121
Hidalgo County,New Mexico,4180,4003,-177,-4.234
Okfuskee County,Oklahoma,11314,11134,-180,-1.591
Brooks County,Texas,7086,6906,-180,-2.54
Mercer County,Ohio,42528,42348,-180,-0.423
Wheeler County,Texas,4987,4807,-180,-3.609
Calhoun County,Florida,13644,13464,-180,-1.319
Wayne County,Missouri,10973,10792,-181,-1.65
Phillips County,Kansas,4990,4809,-181,-3.627
Franklin County,Alabama,32113,31932,-181,-0.564
Benson County,North Dakota,5951,5770,-181,-3.042
Potter County,Pennsylvania,16401,16220,-181,-1.104
Eaton County,Michigan,109174,108992,-182,-0.167
Sheboygan County,Wisconsin,118023,117841,-182,-0.154
DeKalb County,Illinois,100415,100232,-183,-0.182
Freeborn County,Minnesota,30901,30718,-183,-0.592
Wilkes County,North Carolina,65968,65784,-184,-0.279
Winona County,Minnesota,49662,49478,-184,-0.371
Lawrence County,Kentucky,16293,16109,-184,-1.129
Marion County,Alabama,29341,29156,-185,-0.631
Winchester city,Virginia,28122,27936,-186,-0.661
Sioux County,North Dakota,3897,3711,-186,-4.773
McCreary County,Kentucky,16887,16701,-186,-1.101
Fayette County,Illinois,21492,21305,-187,-0.87
Wilkinson County,Georgia,8868,8681,-187,-2.109
Manitowoc County,Wisconsin,81360,81172,-188,-0.231
Iowa County,Iowa,16663,16475,-188,-1.128
Cass County,Michigan,51591,51403,-188,-0.364
Pershing County,Nevada,6651,6462,-189,-2.842
Modoc County,California,8700,8511,-189,-2.172
Calhoun County,Iowa,9914,9725,-189,-1.906
Lincoln County,Mississippi,34906,34717,-189,-0.541
Miller County,Georgia,5997,5807,-190,-3.168
Starr County,Texas,65918,65728,-190,-0.288
Washita County,Oklahoma,10922,10732,-190,-1.74
Carroll County,Iowa,20757,20567,-190,-0.915
Mercer County,Illinois,15694,15504,-190,-1.211
Lee County,Virginia,22173,21982,-191,-0.861
Hale County,Alabama,14786,14595,-191,-1.292
Mason County,Kentucky,17121,16930,-191,-1.116
Brown County,Minnesota,25914,25723,-191,-0.737
Poweshiek County,Iowa,18658,18467,-191,-1.024
Martin County,Kentucky,11287,11095,-192,-1.701
Roane County,West Virginia,14028,13834,-194,-1.383
Toombs County,Georgia,27031,26837,-194,-0.718
Presidio County,Texas,6134,5939,-195,-3.179
Jackson Parish,Louisiana,15034,14839,-195,-1.297
Blackford County,Indiana,12115,11919,-196,-1.618
Hocking County,Ohio,28054,27858,-196,-0.699
Clark County,Arkansas,21447,21250,-197,-0.919
Tucker County,West Virginia,6765,6568,-197,-2.912
Quay County,New Mexico,8744,8546,-198,-2.264
Moultrie County,Illinois,14523,14323,-200,-1.377
Pulaski County,Illinois,5191,4991,-200,-3.853
De Witt County,Illinois,15510,15310,-200,-1.289
Jefferson County,Indiana,33147,32946,-201,-0.606
Brewster County,Texas,9545,9343,-202,-2.116
Jasper County,Mississippi,16370,16167,-203,-1.24
Rutland County,Vermont,60570,60366,-204,-0.337
Lipscomb County,Texas,3058,2854,-204,-6.671
Red River Parish,Louisiana,7624,7420,-204,-2.676
Haskell County,Kansas,3781,3576,-205,-5.422
Renville County,Minnesota,14730,14525,-205,-1.392
Burke County,Georgia,24594,24388,-206,-0.838
Summers County,West Virginia,11968,11762,-206,-1.721
Washington County,Oregon,600383,600176,-207,-0.034
Little River County,Arkansas,12028,11821,-207,-1.721
Emmet County,Iowa,9383,9176,-207,-2.206
Prentiss County,Mississippi,25000,24792,-208,-0.832
Deaf Smith County,Texas,18585,18377,-208,-1.119
Fayette County,Alabama,16326,16118,-208,-1.274
McPherson County,Kansas,30220,30012,-208,-0.688
Choctaw County,Mississippi,8246,8037,-209,-2.535
Lafayette County,Arkansas,6311,6101,-210,-3.328
Seminole County,Oklahoma,23562,23351,-211,-0.896
Richland County,Wisconsin,17302,17090,-212,-1.225
Webster County,West Virginia,8380,8167,-213,-2.542
Nome Census Area,Alaska,10049,9835,-214,-2.13
Gray County,Texas,21229,21015,-214,-1.008
Rio Grande County,Colorado,11539,11325,-214,-1.855
Koochiching County,Minnesota,12059,11844,-215,-1.783
Prairie County,Arkansas,8284,8069,-215,-2.595
Madison County,Nebraska,35584,35368,-216,-0.607
Ketchikan Gateway Borough,Alaska,13957,13741,-216,-1.548
Coosa County,Alabama,10382,10166,-216,-2.081
Fayette County,Iowa,19511,19294,-217,-1.112
Scott County,Missouri,38058,37840,-218,-0.573
Hamilton County,Iowa,15039,14820,-219,-1.456
Roosevelt County,Montana,10792,10572,-220,-2.039
Mono County,California,13198,12978,-220,-1.667
Appanoose County,Iowa,12315,12094,-221,-1.795
Cibola County,New Mexico,27172,26950,-222,-0.817
Island County,Washington,86847,86625,-222,-0.256
Richland Parish,Louisiana,20049,19826,-223,-1.112
Tattnall County,Georgia,24287,24064,-223,-0.918
Chugach Census Area,Alaska,7097,6874,-223,-3.142
Dimmit County,Texas,8611,8387,-224,-2.601
Jefferson Davis Parish,Louisiana,32250,32026,-224,-0.695
Choctaw County,Alabama,12663,12439,-224,-1.769
Marshall County,Iowa,40104,39879,-225,-0.561
Wood County,Wisconsin,74218,73993,-225,-0.303
North Slope Borough,Alaska,11030,10805,-225,-2.04
Garrett County,Maryland,28804,28579,-225,-0.781
Accomack County,Virginia,33417,33191,-226,-0.676
Woodruff County,Arkansas,6276,6049,-227,-3.617
Tama County,Iowa,17130,16903,-227,-1.325
Dawson County,Nebraska,24111,23884,-227,-0.941
Howard County,Arkansas,12784,12557,-227,-1.776
Clark County,Illinois,15457,15229,-228,-1.475
Meigs County,Ohio,22197,21969,-228,-1.027
Grady County,Georgia,26237,26008,-229,-0.873
Cross County,Arkansas,16830,16601,-229,-1.361
Jackson County,Oklahoma,24785,24556,-229,-0.924
Las Animas County,Colorado,14557,14327,-230,-1.58
Buena Vista County,Iowa,20830,20600,-230,-1.104
St. Clair County,Michigan,160382,160151,-231,-0.144
Los Alamos County,New Mexico,19418,19187,-231,-1.19
Carter County,Kentucky,26626,26395,-231,-0.868
Adams County,Nebraska,31202,30970,-232,-0.744
Sandusky County,Ohio,58900,58667,-233,-0.396
Lee County,Arkansas,8597,8364,-233,-2.71
Atchison County,Kansas,16341,16108,-233,-1.426
Harvey County,Kansas,34034,33801,-233,-0.685
Murray County,Oklahoma,13905,13672,-233,-1.676
Menominee County,Michigan,23500,23266,-234,-0.996
Mahaska County,Iowa,22180,21946,-234,-1.055
Shelby County,Illinois,20995,20761,-234,-1.115
Henderson County,Illinois,6385,6151,-234,-3.665
Jefferson Davis County,Mississippi,11323,11088,-235,-2.075
Monroe County,Arkansas,6799,6564,-235,-3.456
Tishomingo County,Mississippi,18854,18619,-235,-1.246
Palo Alto County,Iowa,8999,8764,-235,-2.611
Clarendon County,South Carolina,31148,30913,-235,-0.754
Hill County,Montana,16304,16068,-236,-1.447
Clay County,West Virginia,8050,7814,-236,-2.932
Greene County,North Carolina,20449,20211,-238,-1.164
Vinton County,Ohio,12804,12565,-239,-1.867
Covington County,Mississippi,18339,18098,-241,-1.314
Avery County,North Carolina,17812,17571,-241,-1.353
Clay County,Illinois,13290,13047,-243,-1.828
Bristol city,Virginia,17218,16975,-243,-1.411
Ritchie County,West Virginia,8450,8207,-243,-2.876
Rosebud County,Montana,8331,8088,-243,-2.917
Scurry County,Texas,16929,16686,-243,-1.435
Yoakum County,Texas,7695,7451,-244,-3.171
Schuyler County,New York,17894,17650,-244,-1.364
Thomas County,Georgia,45806,45561,-245,-0.535
Graves County,Kentucky,36657,36412,-245,-0.668
Ohio County,Kentucky,23772,23527,-245,-1.031
Reagan County,Texas,3383,3135,-248,-7.331
Orange County,Indiana,19872,19623,-249,-1.253
San Miguel County,New Mexico,27203,26953,-250,-0.919
Unicoi County,Tennessee,17924,17674,-250,-1.395
Parmer County,Texas,9871,9620,-251,-2.543
Bent County,Colorado,5651,5399,-252,-4.459
Pike County,Illinois,14737,14484,-253,-1.717
Washington County,Georgia,19992,19738,-254,-1.271
Victoria County,Texas,91320,91065,-255,-0.279
Clay County,Mississippi,18635,18380,-255,-1.368
Richland County,Montana,11493,11237,-256,-2.227
Moniteau County,Missouri,15477,15220,-257,-1.661
Union County,Iowa,12145,11887,-258,-2.124
White County,Illinois,13872,13614,-258,-1.86
Marion County,West Virginia,56211,55952,-259,-0.461
Rolette County,North Dakota,12192,11933,-259,-2.124
Greenlee County,Arizona,9561,9302,-259,-2.709
Wright County,Iowa,12941,12681,-260,-2.009
Lewis County,West Virginia,17028,16767,-261,-1.533
Ashland County,Ohio,52443,52181,-262,-0.5
Thurston County,Nebraska,6769,6507,-262,-3.871
Nolan County,Texas,14736,14473,-263,-1.785
Roosevelt County,New Mexico,19197,18934,-263,-1.37
Braxton County,West Virginia,12449,12185,-264,-2.121
Carroll County,Mississippi,9995,9731,-264,-2.641
Newton County,Mississippi,21293,21029,-264,-1.24
Terry County,Texas,11832,11567,-265,-2.24
Rowan County,Kentucky,24654,24388,-266,-1.079
Washington County,Alabama,15388,15122,-266,-1.729
Montgomery County,Illinois,28287,28020,-267,-0.944
Nicholas County,West Virginia,24603,24335,-268,-1.089
Kingman County,Kansas,7461,7193,-268,-3.592
Lincoln Parish,Louisiana,48398,48129,-269,-0.556
Cherokee County,Kansas,19357,19088,-269,-1.39
Monona County,Iowa,8757,8486,-271,-3.095
Lamar County,Alabama,13976,13705,-271,-1.939
Woodbury County,Iowa,105944,105671,-273,-0.258
Wabash County,Illinois,11361,11087,-274,-2.412
Jersey County,Illinois,21520,21246,-274,-1.273
Indiana County,Pennsylvania,83231,82957,-274,-0.329
Hardin County,Ohio,30691,30416,-275,-0.896
Green County,Wisconsin,37092,36816,-276,-0.744
Big Horn County,Montana,13127,12851,-276,-2.103
Lyon County,Kansas,32177,31898,-279,-0.867
Major County,Oklahoma,7781,7502,-279,-3.586
West Carroll Parish,Louisiana,9755,9475,-280,-2.87
Jay County,Indiana,20478,20198,-280,-1.367
Scott County,Mississippi,27987,27707,-280,-1
Andrews County,Texas,18614,18334,-280,-1.504
Massac County,Illinois,14176,13896,-280,-1.975
Early County,Georgia,10855,10574,-281,-2.589
Columbia County,New York,61567,61286,-281,-0.456
Magoffin County,Kentucky,11639,11357,-282,-2.423
Wayne County,Indiana,66555,66273,-282,-0.424
Ford County,Illinois,13531,13249,-282,-2.084
Clay County,Arkansas,14548,14265,-283,-1.945
Jo Daviess County,Illinois,22042,21758,-284,-1.288
Emporia city,Virginia,5766,5481,-285,-4.943
Columbia County,Wisconsin,58480,58193,-287,-0.491
Webster County,Kentucky,13014,12726,-288,-2.213
Dallas County,Arkansas,6479,6191,-288,-4.445
Noxubee County,Mississippi,10279,9990,-289,-2.812
White Pine County,Nevada,9078,8788,-290,-3.195
Floyd County,Iowa,15627,15337,-290,-1.856
Chickasaw County,Mississippi,17103,16812,-291,-1.701
Boone County,Illinois,53446,53154,-292,-0.546
Henry County,Iowa,20488,20196,-292,-1.425
Montgomery County,Mississippi,9822,9530,-292,-2.973
Zavala County,Texas,9670,9377,-293,-3.03
Bibb County,Alabama,22300,22005,-295,-1.323
Livingston County,Illinois,35816,35521,-295,-0.824
Lee County,Illinois,34144,33848,-296,-0.867
Lackawanna County,Pennsylvania,215911,215615,-296,-0.137
Neosho County,Kansas,15902,15606,-296,-1.861
Stoddard County,Missouri,28674,28377,-297,-1.036
Miami County,Indiana,35972,35674,-298,-0.828
Muskingum County,Ohio,86412,86113,-299,-0.346
Chickasaw County,Iowa,12015,11716,-299,-2.489
Fairbanks North Star Borough,Alaska,95657,95356,-301,-0.315
Tensas Parish,Louisiana,4147,3846,-301,-7.258
Wayne County,Illinois,16173,15872,-301,-1.861
Lawrence County,Mississippi,12015,11713,-302,-2.514
Crowley County,Colorado,5919,5614,-305,-5.153
Hardin County,Iowa,16873,16567,-306,-1.814
Jackson County,Wisconsin,21142,20836,-306,-1.447
Madison County,Ohio,43847,43540,-307,-0.7
Randolph County,Georgia,6423,6116,-307,-4.78
Inyo County,California,19025,18718,-307,-1.614
Jackson County,Michigan,160375,160066,-309,-0.193
Sharkey County,Mississippi,3798,3488,-310,-8.162
Chippewa County,Minnesota,12594,12284,-310,-2.461
Rio Arriba County,New Mexico,40359,40048,-311,-0.771
Haywood County,Tennessee,17862,17550,-312,-1.747
Saline County,Missouri,23319,23007,-312,-1.338
Greene County,Alabama,7734,7422,-312,-4.034
Cole County,Missouri,77284,76969,-315,-0.408
Fond du Lac County,Wisconsin,104152,103836,-316,-0.303
Macon County,Georgia,12081,11765,-316,-2.616
Yates County,New York,24768,24451,-317,-1.28
Lamb County,Texas,13043,12724,-319,-2.446
Tunica County,Mississippi,9777,9458,-319,-3.263
Herkimer County,New York,60143,59822,-321,-0.534
Blaine County,Oklahoma,8731,8409,-322,-3.688
Woodford County,Illinois,38450,38128,-322,-0.837
Waupaca County,Wisconsin,51811,51488,-323,-0.623
Houghton County,Michigan,37360,37035,-325,-0.87
Livingston County,New York,61842,61516,-326,-0.527
Kemper County,Mississippi,8981,8654,-327,-3.641
Wyandot County,Ohio,21894,21567,-327,-1.494
Dawson County,Texas,12457,12130,-327,-2.625
Bleckley County,Georgia,12585,12257,-328,-2.606
Branch County,Michigan,44860,44531,-329,-0.733
Brown County,South Dakota,38301,37972,-329,-0.859
Cass County,Indiana,37870,37540,-330,-0.871
Claiborne County,Mississippi,9135,8805,-330,-3.612
Wayne County,Ohio,116889,116559,-330,-0.282
Trinity County,California,16112,15781,-331,-2.054
Randolph County,West Virginia,27934,27600,-334,-1.196
Cooper County,Missouri,17108,16772,-336,-1.964
Guernsey County,Ohio,38434,38098,-336,-0.874
Catahoula Parish,Louisiana,8903,8566,-337,-3.785
Wilson County,North Carolina,78786,78449,-337,-0.428
Greene County,Illinois,11988,11651,-337,-2.811
Russell County,Virginia,25786,25448,-338,-1.311
Giles County,Virginia,16792,16453,-339,-2.019
Tallapoosa County,Alabama,41316,40977,-339,-0.821
Chicot County,Arkansas,10212,9873,-339,-3.32
Florence County,South Carolina,137064,136721,-343,-0.25
Mason County,Illinois,13091,12748,-343,-2.62
Twiggs County,Georgia,8023,7680,-343,-4.275
Clarke County,Mississippi,15615,15271,-344,-2.203
Clinton County,Indiana,33188,32843,-345,-1.04
Lauderdale County,Tennessee,25139,24793,-346,-1.376
Hancock County,Georgia,8733,8387,-346,-3.962
Effingham County,Illinois,34671,34325,-346,-0.998
Kossuth County,Iowa,14822,14475,-347,-2.341
Nobles County,Minnesota,22294,21947,-347,-1.556
Huron County,Ohio,58565,58218,-347,-0.593
Forest County,Pennsylvania,6974,6626,-348,-4.99
Bienville Parish,Louisiana,12989,12641,-348,-2.679
Susquehanna County,Pennsylvania,38423,38074,-349,-0.908
Smyth County,Virginia,29800,29449,-351,-1.178
Whitman County,Washington,47971,47619,-352,-0.734
Perry County,Illinois,20940,20588,-352,-1.681
Oktibbeha County,Mississippi,51780,51427,-353,-0.682
Etowah County,Alabama,103441,103088,-353,-0.341
Natrona County,Wyoming,79955,79601,-354,-0.443
Darke County,Ohio,51883,51529,-354,-0.682
Worth County,Georgia,20783,20424,-359,-1.727
Taylor County,West Virginia,16701,16342,-359,-2.15
Josephine County,Oregon,88092,87730,-362,-0.411
Danville city,Virginia,42592,42229,-363,-0.852
Chester County,South Carolina,32294,31931,-363,-1.124
Simpson County,Mississippi,25950,25587,-363,-1.399
Evangeline Parish,Louisiana,32351,31986,-365,-1.128
Richland County,Illinois,15800,15435,-365,-2.31
Monroe County,Alabama,19770,19404,-366,-1.851
Moore County,Texas,21362,20996,-366,-1.713
Breathitt County,Kentucky,13717,13351,-366,-2.668
Jefferson County,Wisconsin,86151,85784,-367,-0.426
Jackson County,Illinois,52984,52617,-367,-0.693
Northwest Arctic Borough,Alaska,7790,7423,-367,-4.711
Lawrence County,Illinois,15283,14914,-369,-2.414
Webster County,Iowa,36996,36626,-370,-1
Liberty County,Florida,7976,7603,-373,-4.677
Martin County,Minnesota,20024,19650,-374,-1.868
Attala County,Mississippi,17885,17509,-376,-2.102
McDonough County,Illinois,27237,26861,-376,-1.38
Lee County,South Carolina,16530,16153,-377,-2.281
Ottawa County,Ohio,40355,39978,-377,-0.934
Tuscola County,Michigan,53322,52945,-377,-0.707
Hancock County,Illinois,17621,17244,-377,-2.139
Halifax County,Virginia,34022,33644,-378,-1.111
Northampton County,Virginia,12278,11900,-378,-3.079
Knott County,Kentucky,14253,13874,-379,-2.659
Tippah County,Mississippi,21810,21431,-379,-1.738
Kodiak Island Borough,Alaska,13101,12720,-381,-2.908
McCracken County,Kentucky,67871,67490,-381,-0.561
Hockley County,Texas,21543,21161,-382,-1.773
Reno County,Kansas,61898,61516,-382,-0.617
Alexander County,Illinois,5242,4858,-384,-7.325
Alleghany County,Virginia,15219,14835,-384,-2.523
Union Parish,Louisiana,21106,20721,-385,-1.824
Beaufort County,North Carolina,44658,44272,-386,-0.864
Decatur County,Georgia,29369,28982,-387,-1.318
Cass County,Illinois,13044,12657,-387,-2.967
Lee County,Mississippi,83347,82959,-388,-0.466
Marion County,Mississippi,24438,24050,-388,-1.588
Otero County,Colorado,18692,18303,-389,-2.081
Conecuh County,Alabama,11597,11206,-391,-3.372
Vanderburgh County,Indiana,180136,179744,-392,-0.218
Dyer County,Tennessee,36803,36410,-393,-1.068
Obion County,Tennessee,30788,30394,-394,-1.28
Logan County,Illinois,27986,27591,-395,-1.411
Hutchinson County,Texas,20614,20215,-399,-1.936
Calhoun County,Texas,20105,19706,-399,-1.985
Wilbarger County,Texas,12891,12491,-400,-3.103
Jefferson County,Georgia,15714,15314,-400,-2.546
Crawford County,Missouri,23059,22659,-400,-1.735
East Feliciana Parish,Louisiana,19536,19135,-401,-2.053
Bureau County,Illinois,33229,32828,-401,-1.207
Beckham County,Oklahoma,22411,22009,-402,-1.794
Wapello County,Iowa,35445,35043,-402,-1.134
Preble County,Ohio,40998,40596,-402,-0.981
Crawford County,Iowa,16526,16123,-403,-2.439
Dickenson County,Virginia,14129,13725,-404,-2.859
Bamberg County,South Carolina,13313,12908,-405,-3.042
Butler County,Alabama,19055,18650,-405,-2.125
Knox County,Kentucky,30196,29791,-405,-1.341
Bradley County,Arkansas,10540,10135,-405,-3.843
Ochiltree County,Texas,10015,9606,-409,-4.084
Maui County,Hawaii,164762,164351,-411,-0.249
Bethel Census Area,Alaska,18670,18257,-413,-2.212
Siskiyou County,California,44075,43660,-415,-0.942
Barton County,Kansas,25495,25080,-415,-1.628
Wetzel County,West Virginia,14441,14025,-416,-2.881
Gadsden County,Florida,43820,43403,-417,-0.952
Crisp County,Georgia,20127,19708,-419,-2.082
Putnam County,West Virginia,57435,57015,-420,-0.731
Neshoba County,Mississippi,29094,28673,-421,-1.447
Leslie County,Kentucky,10516,10093,-423,-4.022
Claiborne Parish,Louisiana,14168,13744,-424,-2.993
Bristol County,Rhode Island,50786,50360,-426,-0.839
Clay County,Kentucky,20339,19913,-426,-2.094
Henrico County,Virginia,334389,333962,-427,-0.128
Pickens County,Alabama,19124,18697,-427,-2.233
San Luis Obispo County,California,282443,282013,-430,-0.152
Terrell County,Georgia,9184,8754,-430,-4.682
Allen Parish,Louisiana,22751,22320,-431,-1.894
Washington Parish,Louisiana,45456,45025,-431,-0.948
Labette County,Kansas,20188,19757,-431,-2.135
Vance County,North Carolina,42570,42138,-432,-1.015
Ford County,Kansas,34282,33848,-434,-1.266
Edgar County,Illinois,16868,16433,-435,-2.579
Johnson County,Kentucky,22679,22244,-435,-1.918
Assumption Parish,Louisiana,21040,20604,-436,-2.072
Drew County,Arkansas,17348,16911,-437,-2.519
Ogle County,Illinois,51788,51351,-437,-0.844
Lafayette County,Florida,8225,7786,-439,-5.337
Wilkinson County,Mississippi,8586,8143,-443,-5.16
Eagle County,Colorado,55730,55285,-445,-0.798
Plumas County,California,19796,19351,-445,-2.248
Seneca County,Ohio,55080,54632,-448,-0.813
Mason County,West Virginia,25448,25000,-448,-1.76
Hampton County,South Carolina,18561,18113,-448,-2.414
Essex County,New York,37362,36910,-452,-1.21
Williams County,Ohio,37106,36652,-454,-1.224
Humphreys County,Mississippi,7790,7333,-457,-5.866
Allendale County,South Carolina,8037,7579,-458,-5.699
Williamson County,Illinois,67154,66695,-459,-0.684
Baker County,Florida,28263,27803,-460,-1.628
Washington County,New York,61302,60841,-461,-0.752
Pecos County,Texas,15197,14735,-462,-3.04
Polk County,Minnesota,31194,30731,-463,-1.484
Franklin Parish,Louisiana,19774,19308,-466,-2.357
Norfolk County,Massachusetts,725999,725531,-468,-0.064
East Carroll Parish,Louisiana,7460,6990,-470,-6.3
Poinsett County,Arkansas,22965,22495,-470,-2.047
Suffolk County,New York,1525936,1525465,-471,-0.031
Quitman County,Mississippi,6173,5701,-472,-7.646
Auglaize County,Ohio,46421,45948,-473,-1.019
Muhlenberg County,Kentucky,30930,30455,-475,-1.536
Union County,Illinois,17243,16767,-476,-2.761
Perry County,Alabama,8515,8035,-480,-5.637
Scotts Bluff County,Nebraska,36084,35603,-481,-1.333
Pitkin County,Colorado,17358,16876,-482,-2.777
Woodward County,Oklahoma,20473,19990,-483,-2.359
Winkler County,Texas,7791,7306,-485,-6.225
Calhoun County,Mississippi,13267,12781,-486,-3.663
Warren County,Illinois,16840,16354,-486,-2.886
Socorro County,New Mexico,16602,16115,-487,-2.933
Summit County,Colorado,31052,30565,-487,-1.568
Montgomery County,Kansas,31484,30996,-488,-1.55
Union County,South Carolina,27240,26752,-488,-1.791
Crawford County,Ohio,42010,41522,-488,-1.162
Ross County,Ohio,77095,76606,-489,-0.634
Kalamazoo County,Michigan,261663,261173,-490,-0.187
Chippewa County,Michigan,36784,36293,-491,-1.335
Lenoir County,North Carolina,55124,54633,-491,-0.891
Sumter County,Alabama,12348,11853,-495,-4.009
Fairfield County,South Carolina,20951,20455,-496,-2.367
Knox County,Indiana,36286,35789,-497,-1.37
Pottawattamie County,Iowa,93670,93173,-497,-0.531
Lake County,Tennessee,7004,6507,-497,-7.096
Jasper County,Texas,32983,32484,-499,-1.513
La Crosse County,Wisconsin,120796,120294,-502,-0.416
Grant County,New Mexico,28190,27686,-504,-1.788
Elk County,Pennsylvania,30984,30477,-507,-1.636
Darlington County,South Carolina,62907,62398,-509,-0.809
Carson City,Nevada,58644,58130,-514,-0.876
Manassas Park city,Virginia,17217,16703,-514,-2.985
Taylor County,Florida,21800,21283,-517,-2.372
Barbour County,Alabama,25224,24706,-518,-2.054
Mountrail County,North Dakota,9812,9290,-522,-5.32
Martin County,North Carolina,22035,21508,-527,-2.392
St. Martin Parish,Louisiana,51766,51236,-530,-1.024
Audrain County,Missouri,24964,24434,-530,-2.123
Coles County,Illinois,46865,46334,-531,-1.133
Lowndes County,Alabama,10310,9777,-533,-5.17
Bell County,Kentucky,24102,23568,-534,-2.216
Madison Parish,Louisiana,10015,9478,-537,-5.362
Alcorn County,Mississippi,34743,34204,-539,-1.551
Grenada County,Mississippi,21627,21088,-539,-2.492
Irwin County,Georgia,9667,9126,-541,-5.596
Fulton County,Ohio,42713,42171,-542,-1.269
Wilcox County,Alabama,10601,10059,-542,-5.113
Greenbrier County,West Virginia,32979,32435,-544,-1.65
Dakota County,Nebraska,21587,21042,-545,-2.525
Campbell County,Virginia,55689,55141,-548,-0.984
Panola County,Mississippi,33209,32661,-548,-1.65
Winn Parish,Louisiana,13755,13205,-550,-3.999
Pittsylvania County,Virginia,60502,59952,-550,-0.909
Shelby County,Ohio,48222,47671,-551,-1.143
Franklin County,Illinois,37798,37242,-556,-1.471
Dillon County,South Carolina,28295,27738,-557,-1.969
Lincoln County,West Virginia,20459,19901,-558,-2.727
McKean County,Pennsylvania,40426,39866,-560,-1.385
Concordia Parish,Louisiana,18681,18116,-565,-3.024
Greenup County,Kentucky,35970,35403,-567,-1.576
Juneau City and Borough,Alaska,32255,31685,-570,-1.767
Nodaway County,Missouri,21240,20670,-570,-2.684
Clarke County,Alabama,23087,22515,-572,-2.478
Glenn County,California,28915,28339,-576,-1.992
Frio County,Texas,18392,17815,-577,-3.137
Marengo County,Alabama,19324,18745,-579,-2.996
Columbia County,Arkansas,22798,22216,-582,-2.553
Ashtabula County,Ohio,97596,97014,-582,-0.596
Tehama County,California,65831,65245,-586,-0.89
Dubuque County,Iowa,99264,98677,-587,-0.591
Fulton County,Illinois,33611,33021,-590,-1.755
Apache County,Arizona,66024,65432,-592,-0.897
Christian County,Illinois,34031,33436,-595,-1.748
Edgecombe County,North Carolina,48897,48301,-596,-1.219
Ouachita County,Arkansas,22648,22049,-599,-2.645
Cattaraugus County,New York,77041,76439,-602,-0.781
Monroe County,Mississippi,34179,33577,-602,-1.761
Seward County,Kansas,21962,21358,-604,-2.75
Pointe Coupee Parish,Louisiana,20757,20151,-606,-2.919
Iroquois County,Illinois,27079,26473,-606,-2.238
Hempstead County,Arkansas,20062,19453,-609,-3.036
Hopkins County,Kentucky,45422,44812,-610,-1.343
Des Moines County,Iowa,38907,38293,-614,-1.578
Tazewell County,Virginia,40439,39821,-618,-1.528
Lane County,Oregon,382975,382353,-622,-0.162
Desha County,Arkansas,11395,10771,-624,-5.476
Marlboro County,South Carolina,26668,26039,-629,-2.359
Russell County,Alabama,59187,58555,-632,-1.068
Ware County,Georgia,36247,35614,-633,-1.746
Custer County,Oklahoma,28521,27886,-635,-2.226
St. Francis County,Arkansas,23089,22451,-638,-2.763
Arkansas County,Arkansas,17150,16512,-638,-3.72
Grant County,Indiana,66661,66022,-639,-0.959
Dooly County,Georgia,11212,10572,-640,-5.708
Mitchell County,Georgia,21762,21116,-646,-2.968
Gratiot County,Michigan,41752,41100,-652,-1.562
Harrisonburg city,Virginia,51810,51158,-652,-1.258
Copiah County,Mississippi,28371,27719,-652,-2.298
Fulton County,New York,53322,52669,-653,-1.225
Calhoun County,Alabama,116444,115788,-656,-0.563
Letcher County,Kentucky,21551,20893,-658,-3.053
Wood County,Ohio,132251,131592,-659,-0.498
Del Norte County,California,27745,27082,-663,-2.39
Stewart County,Georgia,5312,4648,-664,-12.5
Bee County,Texas,31061,30394,-667,-2.147
Grant County,Wisconsin,51950,51276,-674,-1.297
Jackson County,Missouri,717206,716531,-675,-0.094
Kleberg County,Texas,31038,30362,-676,-2.178
Hertford County,North Carolina,21552,20875,-677,-3.141
Venango County,Pennsylvania,50455,49777,-678,-1.344
Union County,Florida,16138,15460,-678,-4.201
Jones County,Mississippi,67248,66569,-679,-1.01
St. Joseph County,Indiana,272914,272234,-680,-0.249
Tallahatchie County,Mississippi,12715,12035,-680,-5.348
Lake County,Ohio,232524,231842,-682,-0.293
Ward County,Texas,11648,10964,-684,-5.872
Saline County,Illinois,23772,23087,-685,-2.882
Pike County,Mississippi,40329,39644,-685,-1.699
Chambers County,Alabama,34774,34088,-686,-1.973
Cortland County,New York,46814,46126,-688,-1.47
Tioga County,New York,48461,47772,-689,-1.422
St. Louis County,Minnesota,200223,199532,-691,-0.345
Bertie County,North Carolina,17934,17240,-694,-3.87
Northampton County,North Carolina,17474,16779,-695,-3.977
Walla Walla County,Washington,62586,61890,-696,-1.112
Wise County,Virginia,36118,35421,-697,-1.93
Hale County,Texas,32526,31827,-699,-2.149
Jefferson County,Pennsylvania,44496,43794,-702,-1.578
Logan County,Colorado,21527,20823,-704,-3.27
Saline County,Kansas,54301,53596,-705,-1.298
Morgan County,Illinois,32917,32209,-708,-2.151
Lee County,Iowa,33548,32840,-708,-2.11
Union County,Kentucky,13670,12961,-709,-5.187
Ashley County,Arkansas,19064,18354,-710,-3.724
Cameron Parish,Louisiana,5619,4902,-717,-12.76
Jefferson County,Illinois,37118,36400,-718,-1.934
Macoupin County,Illinois,44967,44245,-722,-1.606
Cerro Gordo County,Iowa,43132,42409,-723,-1.676
Marion County,Ohio,65366,64642,-724,-1.108
Iberville Parish,Louisiana,30240,29506,-734,-2.427
Sumter County,Georgia,29612,28877,-735,-2.482
Caddo County,Oklahoma,26934,26198,-736,-2.733
Marion County,South Carolina,29187,28450,-737,-2.525
New Madrid County,Missouri,16435,15695,-740,-4.503
Columbus County,North Carolina,50625,49885,-740,-1.462
Scott County,Iowa,174669,173924,-745,-0.427
Henderson County,Kentucky,44791,44046,-745,-1.663
LaPorte County,Indiana,112422,111675,-747,-0.664
Chattahoochee County,Georgia,9568,8819,-749,-7.828
Grand Forks County,North Dakota,73169,72413,-756,-1.033
Chenango County,New York,47216,46458,-758,-1.605
St. Lawrence County,New York,108502,107733,-769,-0.709
St. James Parish,Louisiana,20194,19423,-771,-3.818
Halifax County,North Carolina,48622,47848,-774,-1.592
St. Landry Parish,Louisiana,82552,81773,-779,-0.944
Ingham County,Michigan,284891,284108,-783,-0.275
Warren County,Pennsylvania,38594,37808,-786,-2.037
Hamilton County,Florida,14006,13217,-789,-5.633
Hall County,Nebraska,62893,62097,-796,-1.266
Yazoo County,Mississippi,26748,25948,-800,-2.991
McKenzie County,North Dakota,14709,13908,-801,-5.446
Montgomery County,Virginia,99717,98915,-802,-0.804
Armstrong County,Pennsylvania,65553,64747,-806,-1.23
Huntingdon County,Pennsylvania,44094,43281,-813,-1.844
Marion County,Illinois,37727,36914,-813,-2.155
Finney County,Kansas,38467,37650,-817,-2.124
Brooke County,West Virginia,22551,21733,-818,-3.627
Pemiscot County,Missouri,15661,14841,-820,-5.236
Acadia Parish,Louisiana,57569,56744,-825,-1.433
Marshall County,West Virginia,30589,29752,-837,-2.736
Boone County,West Virginia,21807,20968,-839,-3.847
Stark County,North Dakota,33647,32803,-844,-2.508
Allegany County,Maryland,68115,67267,-848,-1.245
Riley County,Kansas,71963,71108,-855,-1.188
Natchitoches Parish,Louisiana,37519,36663,-856,-2.282
Lenawee County,Michigan,99424,98567,-857,-0.862
Genesee County,New York,58394,57535,-859,-1.471
Wyoming County,West Virginia,21387,20527,-860,-4.021
Muscatine County,Iowa,43242,42377,-865,-2
Wyoming County,New York,40531,39666,-865,-2.134
Washington County,Ohio,59769,58901,-868,-1.452
Bowie County,Texas,92903,92035,-868,-0.934
Henry County,Illinois,49290,48419,-871,-1.767
Black Hawk County,Iowa,131147,130274,-873,-0.666
Sacramento County,California,1585046,1584169,-877,-0.055
Dunklin County,Missouri,28286,27406,-880,-3.111
Holmes County,Mississippi,17001,16121,-880,-5.176
Portsmouth city,Virginia,97915,97029,-886,-0.905
Mississippi County,Missouri,12575,11688,-887,-7.054
Texas County,Oklahoma,21386,20495,-891,-4.166
Curry County,New Mexico,48429,47532,-897,-1.852
Madison County,New York,68012,67097,-915,-1.345
Jefferson County,Ohio,65247,64330,-917,-1.405
Sweetwater County,Wyoming,42267,41345,-922,-2.181
Hancock County,West Virginia,29095,28172,-923,-3.172
Garfield County,Oklahoma,62844,61920,-924,-1.47
Seneca County,New York,33811,32882,-929,-2.748
Avoyelles Parish,Louisiana,39690,38751,-939,-2.366
Mercer County,West Virginia,59660,58700,-960,-1.609
Wood County,West Virginia,84300,83340,-960,-1.139
Williamsburg County,South Carolina,31019,30058,-961,-3.098
Tompkins County,New York,105744,104777,-967,-0.914
Floyd County,Kentucky,35948,34978,-970,-2.698
Steuben County,New York,93577,92599,-978,-1.045
Wayne County,West Virginia,38983,37998,-985,-2.527
Belmont County,Ohio,66495,65509,-986,-1.483
Bradford County,Florida,28306,27313,-993,-3.508
Lincoln County,Nebraska,34680,33685,-995,-2.869
Stephenson County,Illinois,44623,43627,-996,-2.232
Buchanan County,Virginia,20348,19352,-996,-4.895
Imperial County,California,179709,178713,-996,-0.554
Ohio County,West Virginia,42444,41447,-997,-2.349
Fayette County,West Virginia,40485,39487,-998,-2.465
Plaquemines Parish,Louisiana,23515,22516,-999,-4.248
Mingo County,West Virginia,23574,22573,-1001,-4.246
Adams County,Illinois,65727,64725,-1002,-1.524
Walker County,Alabama,65342,64339,-1003,-1.535
Calhoun County,Michigan,134293,133289,-1004,-0.748
Harrison County,West Virginia,65922,64915,-1007,-1.528
Winnebago County,Wisconsin,171734,170718,-1016,-0.592
Macon County,Alabama,19534,18516,-1018,-5.211
Whiteside County,Illinois,55691,54658,-1033,-1.855
Bay County,Michigan,103856,102821,-1035,-0.997
Orleans County,New York,40355,39318,-1037,-2.57
Geary County,Kansas,36730,35691,-1039,-2.829
Coconino County,Arizona,145100,144060,-1040,-0.717
Henry County,Virginia,50949,49906,-1043,-2.047
Clayton County,Georgia,297608,296564,-1044,-0.351
Ward County,North Dakota,69933,68870,-1063,-1.52
Lycoming County,Pennsylvania,114182,113104,-1078,-0.944
Clinton County,New York,79839,78753,-1086,-1.36
Allen County,Ohio,102204,101115,-1089,-1.066
Tuolumne County,California,55623,54531,-1092,-1.963
Perry County,Kentucky,28465,27361,-1104,-3.878
Crittenden County,Arkansas,48169,47061,-1108,-2.3
Tom Green County,Texas,120007,118892,-1115,-0.929
Dodge County,Wisconsin,89398,88282,-1116,-1.248
Erie County,Ohio,75619,74501,-1118,-1.478
Monroe County,Pennsylvania,168323,167198,-1125,-0.668
Sutter County,California,99631,98503,-1128,-1.132
Adams County,Mississippi,29538,28408,-1130,-3.826
Orangeburg County,South Carolina,84225,83094,-1131,-1.343
Clark County,Ohio,135973,134831,-1142,-0.84
Bibb County,Georgia,157347,156197,-1150,-0.731
Sunflower County,Mississippi,25973,24811,-1162,-4.474
Monroe County,Florida,82879,81708,-1171,-1.413
Harlan County,Kentucky,26833,25662,-1171,-4.364
Newport County,Rhode Island,85652,84481,-1171,-1.367
Berkshire County,Massachusetts,129036,127859,-1177,-0.912
Charlottesville city,Virginia,46554,45373,-1181,-2.537
Franklin County,New York,47556,46373,-1183,-2.488
Morehouse Parish,Louisiana,25629,24446,-1183,-4.616
Howard County,Texas,34864,33672,-1192,-3.419
Coahoma County,Mississippi,21393,20197,-1196,-5.591
Lawrence County,Pennsylvania,86069,84849,-1220,-1.417
Shasta County,California,182152,180930,-1222,-0.671
San Juan County,New Mexico,121663,120418,-1245,-1.023
Cayuga County,New York,76251,74998,-1253,-1.643
Logan County,West Virginia,32572,31316,-1256,-3.856
Chaves County,New Mexico,65158,63894,-1264,-1.94
Crawford County,Pennsylvania,83937,82670,-1267,-1.509
McDowell County,West Virginia,19118,17850,-1268,-6.632
Linn County,Iowa,230303,229033,-1270,-0.551
Phillips County,Arkansas,16576,15304,-1272,-7.674
Lowndes County,Mississippi,58882,57603,-1279,-2.172
Greene County,Pennsylvania,35946,34663,-1283,-3.569
Rensselaer County,New York,161138,159853,-1285,-0.797
Union County,Arkansas,39049,37752,-1297,-3.321
Webster Parish,Louisiana,36963,35643,-1320,-3.571
Tuscarawas County,Ohio,93265,91937,-1328,-1.424
Knox County,Illinois,49971,48640,-1331,-2.664
Kenosha County,Wisconsin,169156,167817,-1339,-0.792
Columbiana County,Ohio,101873,100511,-1362,-1.337
Berrien County,Michigan,154320,152900,-1420,-0.92
Tazewell County,Illinois,131334,129911,-1423,-1.083
Trumbull County,Ohio,202069,200643,-1426,-0.706
Shawnee County,Kansas,178909,177480,-1429,-0.799
Kankakee County,Illinois,107508,106074,-1434,-1.334
Mercer County,Pennsylvania,110656,109220,-1436,-1.298
Somerset County,Pennsylvania,74147,72710,-1437,-1.938
Talladega County,Alabama,82152,80704,-1448,-1.763
Humboldt County,California,136465,135010,-1455,-1.066
Bucks County,Pennsylvania,646526,645054,-1472,-0.228
Nueces County,Texas,353170,351674,-1496,-0.424
Vernon Parish,Louisiana,48754,47247,-1507,-3.091
Northumberland County,Pennsylvania,91647,90133,-1514,-1.652
Sumter County,South Carolina,105554,104012,-1542,-1.461
St. Charles Parish,Louisiana,52548,50998,-1550,-2.95
Broome County,New York,198675,197117,-1558,-0.784
DeKalb County,Georgia,764386,762820,-1566,-0.205
Lawrence County,Ohio,58236,56653,-1583,-2.718
LaSalle County,Illinois,109663,108078,-1585,-1.445
Bolivar County,Mississippi,30973,29370,-1603,-5.175
Stanislaus County,California,552880,551275,-1605,-0.29
St. Mary Parish,Louisiana,49405,47789,-1616,-3.271
Cabell County,West Virginia,94346,92730,-1616,-1.713
Jackson County,Oregon,223262,221644,-1618,-0.725
Chautauqua County,New York,127675,126027,-1648,-1.291
Delaware County,Pennsylvania,576842,575182,-1660,-0.288
Lafourche Parish,Louisiana,97552,95870,-1682,-1.724
Dallas County,Alabama,38463,36767,-1696,-4.409
Raleigh County,West Virginia,74581,72882,-1699,-2.278
Middlesex County,New Jersey,863183,861418,-1765,-0.204
Niagara County,New York,212650,210880,-1770,-0.832
Leflore County,Mississippi,28348,26570,-1778,-6.272
Blair County,Pennsylvania,122820,121032,-1788,-1.456
Mississippi County,Arkansas,40692,38896,-1796,-4.414
Saginaw County,Michigan,190128,188330,-1798,-0.946
Sangamon County,Illinois,196338,194534,-1804,-0.919
Mendocino County,California,91595,89783,-1812,-1.978
Scioto County,Ohio,74012,72194,-1818,-2.456
Reeves County,Texas,14741,12905,-1836,-12.455
Vermilion County,Illinois,74199,72337,-1862,-2.509
Racine County,Wisconsin,197720,195846,-1874,-0.948
Buchanan County,Missouri,84798,82911,-1887,-2.225
Eddy County,New Mexico,62314,60400,-1914,-3.072
Newport News city,Virginia,186243,184306,-1937,-1.04
Butler County,Ohio,390378,388420,-1958,-0.502
Iberia Parish,Louisiana,70293,68327,-1966,-2.797
Franklin County,Ohio,1323800,1321820,-1980,-0.15
Madison County,Illinois,265858,263864,-1994,-0.75
Lea County,New Mexico,74455,72452,-2003,-2.69
Cambria County,Pennsylvania,133477,131441,-2036,-1.525
Warren County,Mississippi,44721,42649,-2072,-4.633
Lauderdale County,Mississippi,72983,70904,-2079,-2.849
Roanoke city,Virginia,100015,97847,-2168,-2.168
Stark County,Ohio,374853,372657,-2196,-0.586
Fayette County,Kentucky,322567,320347,-2220,-0.688
Denver County,Colorado,715538,713252,-2286,-0.319
Kane County,Illinois,516520,514182,-2338,-0.453
Pike County,Kentucky,58663,56286,-2377,-4.052
Washington County,Mississippi,44918,42514,-2404,-5.352
Macon County,Illinois,104003,101483,-2520,-2.423
Beaver County,Pennsylvania,168228,165677,-2551,-1.516
Montgomery County,Alabama,228948,226361,-2587,-1.13
Westmoreland County,Pennsylvania,354663,352057,-2606,-0.735
St. John the Baptist Parish,Louisiana,42477,39864,-2613,-6.152
Clearfield County,Pennsylvania,80564,77904,-2660,-3.302
Ouachita Parish,Louisiana,160364,157702,-2662,-1.66
Chemung County,New York,84152,81426,-2726,-3.239
Bergen County,New Jersey,955746,952997,-2749,-0.288
Cumberland County,New Jersey,154148,151356,-2792,-1.811
Dougherty County,Georgia,85790,82966,-2824,-3.292
Lassen County,California,32730,29904,-2826,-8.634
Williams County,North Dakota,40950,38109,-2841,-6.938
Rapides Parish,Louisiana,130030,127189,-2841,-2.185
King County,Washington,2269667,2266789,-2878,-0.127
Potter County,Texas,118527,115645,-2882,-2.432
Mahoning County,Ohio,228621,225636,-2985,-1.306
Jefferson County,Arkansas,67261,64246,-3015,-4.483
Essex County,Massachusetts,809818,806765,-3053,-0.377
Fayette County,Pennsylvania,128816,125755,-3061,-2.376
McKinley County,New Mexico,72898,69830,-3068,-4.209
Rock Island County,Illinois,144678,141527,-3151,-2.178
Winnebago County,Illinois,285350,282188,-3162,-1.108
Erie County,Pennsylvania,270869,267689,-3180,-1.174
Oneida County,New York,232111,228846,-3265,-1.407
Boulder County,Colorado,330764,327468,-3296,-0.996
Mobile County,Alabama,414812,411411,-3401,-0.82
Montgomery County,Ohio,537316,533892,-3424,-0.637
Athens County,Ohio,62421,58979,-3442,-5.514
Peoria County,Illinois,181833,178383,-3450,-1.897
Providence County,Rhode Island,660739,657288,-3451,-0.522
Wyandotte County,Kansas,169230,165746,-3484,-2.059
Napa County,California,138024,134300,-3724,-2.698
Virginia Beach city,Virginia,459471,455618,-3853,-0.839
Bernalillo County,New Mexico,676438,672508,-3930,-0.581
Erie County,New York,954244,950312,-3932,-0.412
Alexandria city,Virginia,159461,155525,-3936,-2.468
Anchorage Municipality,Alaska,291244,287145,-4099,-1.407
Genesee County,Michigan,406217,401983,-4234,-1.042
Ector County,Texas,165171,160869,-4302,-2.605
Muscogee County,Georgia,206922,202616,-4306,-2.081
Butte County,California,211631,207303,-4328,-2.045
Santa Barbara County,California,448217,443837,-4380,-0.977
Summit County,Ohio,540436,535882,-4554,-0.843
Richmond County,New York,495749,491133,-4616,-0.931
Lucas County,Ohio,431273,426643,-4630,-1.074
Arlington County,Virginia,238644,234000,-4644,-1.946
St. Clair County,Illinois,257403,252671,-4732,-1.838
Solano County,California,453490,448747,-4743,-1.046
Hampden County,Massachusetts,465834,461041,-4793,-1.029
Terrebonne Parish,Louisiana,109583,104786,-4797,-4.378
Oakland County,Michigan,1274395,1269431,-4964,-0.39
Norfolk city,Virginia,238001,232995,-5006,-2.103
Lake County,Illinois,714351,709150,-5201,-0.728
Kanawha County,West Virginia,180744,175515,-5229,-2.893
Union County,New Jersey,575352,569815,-5537,-0.962
Hamilton County,Ohio,830625,825037,-5588,-0.673
Jefferson County,Texas,256526,250830,-5696,-2.22
Washtenaw County,Michigan,372265,366376,-5889,-1.582
Monterey County,California,439036,432858,-6178,-1.407
Sonoma County,California,488875,482650,-6225,-1.273
East Baton Rouge Parish,Louisiana,456781,450544,-6237,-1.365
Marin County,California,262318,256018,-6300,-2.402
Santa Cruz County,California,270869,264370,-6499,-2.399
Mercer County,New Jersey,387340,380688,-6652,-1.717
Jefferson County,Colorado,582902,576143,-6759,-1.16
Macomb County,Michigan,881219,874195,-7024,-0.797
Monroe County,New York,759444,752035,-7409,-0.976
Davidson County,Tennessee,715875,708144,-7731,-1.08
Marion County,Indiana,977213,969466,-7747,-0.793
Onondaga County,New York,476511,468249,-8262,-1.734
Baltimore County,Maryland,854554,846161,-8393,-0.982
Caddo Parish,Louisiana,237857,229025,-8832,-3.713
Jefferson County,Alabama,674355,665409,-8946,-1.327
Contra Costa County,California,1165927,1156966,-8961,-0.769
Montgomery County,Maryland,1062054,1052521,-9533,-0.898
Jefferson County,Kentucky,782956,773399,-9557,-1.221
Hinds County,Mississippi,227750,217730,-10020,-4.4
Dallas County,Texas,2611491,2600840,-10651,-0.408
Passaic County,New Jersey,525052,513936,-11116,-2.117
Ventura County,California,843843,832605,-11238,-1.332
Fairfax County,Virginia,1150305,1138331,-11974,-1.041
DuPage County,Illinois,932877,920901,-11976,-1.284
Nassau County,New York,1395777,1383726,-12051,-0.863
Essex County,New Jersey,862782,849477,-13305,-1.542
Shelby County,Tennessee,929722,916371,-13351,-1.436
St. Louis County,Missouri,1004310,990414,-13896,-1.384
Westchester County,New York,1004445,990427,-14018,-1.396
Orleans Parish,Louisiana,383998,369749,-14249,-3.711
Calcasieu Parish,Louisiana,216779,202418,-14361,-6.625
Middlesex County,Massachusetts,1632002,1617105,-14897,-0.913
Jefferson Parish,Louisiana,440794,425884,-14910,-3.383
St. Louis city,Missouri,301574,286578,-14996,-4.973
Baltimore city,Maryland,585693,569931,-15762,-2.691
Ramsey County,Minnesota,552362,536413,-15949,-2.887
Allegheny County,Pennsylvania,1250585,1233253,-17332,-1.386
District of Columbia,District of Columbia,689546,671803,-17743,-2.573
Prince George's County,Maryland,967194,946971,-20223,-2.091
Multnomah County,Oregon,815429,795083,-20346,-2.495
Milwaukee County,Wisconsin,939495,918661,-20834,-2.218
Honolulu County,Hawaii,1016506,995638,-20868,-2.053
Hennepin County,Minnesota,1281568,1260121,-21447,-1.673
Hudson County,New Jersey,724857,703366,-21491,-2.965
San Diego County,California,3298635,3276208,-22427,-0.68
Miami-Dade County,Florida,2701762,2673837,-27925,-1.034
Cuyahoga County,Ohio,1264813,1236041,-28772,-2.275
Suffolk County,Massachusetts,797941,766381,-31560,-3.955
San Mateo County,California,764432,729181,-35251,-4.611
Orange County,California,3186979,3151184,-35795,-1.123
Wayne County,Michigan,1793549,1757043,-36506,-2.035
Philadelphia County,Pennsylvania,1603799,1567258,-36541,-2.278
Alameda County,California,1682331,1628997,-53334,-3.17
Santa Clara County,California,1936274,1870945,-65329,-3.374
San Francisco County,California,873959,808437,-65522,-7.497
Bronx County,New York,1472656,1379946,-92710,-6.295
New York County,New York,1694250,1596273,-97977,-5.783
Queens County,New York,2405464,2278029,-127435,-5.298
Kings County,New York,2736075,2590516,-145559,-5.32
Cook County,Illinois,5275522,5109292,-166230,-3.151
Los Angeles County,California,10014042,9721138,-292904,-2.925
